Origin,Dest,Airline,CarrierDelay,WeatherDelay,NASDelay,SecurityDelay,LateAircraftDelay,TotalDelays
ABE,ATL,Atlantic Southeast Airlines,3009,811,1204,20,764,5808
ABE,CLT,US Airways Inc.,271,94,63,0,0,428
ABE,CVG,Atlantic Southeast Airlines,25,70,15,0,0,110
ABE,ORD,Skywest Airlines Inc.,232,464,4161,0,1053,5910
ABI,DFW,American Eagle Airlines Inc.,8563,2464,2734,0,2080,15841
ABQ,AMA,Southwest Airlines Co.,473,199,39,0,1967,2678
ABQ,ATL,Delta Air Lines Inc.,1282,237,540,0,759,2818
ABQ,BWI,Southwest Airlines Co.,193,166,678,0,158,1195
ABQ,CVG,Delta Air Lines Inc.,98,3,50,0,392,543
ABQ,DAL,Southwest Airlines Co.,2535,804,1073,0,7331,11743
ABQ,DEN,Frontier Airlines Inc.,705,13,503,0,602,1823
ABQ,DEN,Skywest Airlines Inc.,337,106,183,0,1804,2430
ABQ,DEN,Southwest Airlines Co.,337,0,126,0,1864,2327
ABQ,DEN,United Air Lines Inc.,671,17,595,0,5182,6465
ABQ,DFW,American Airlines Inc.,4159,1086,1922,0,7297,14464
ABQ,ELP,Southwest Airlines Co.,788,0,190,0,3193,4171
ABQ,HOU,Southwest Airlines Co.,893,271,234,0,3642,5040
ABQ,IAD,United Air Lines Inc.,984,23,59,0,130,1196
ABQ,LAS,Southwest Airlines Co.,1902,192,2372,0,7804,12270
ABQ,LAX,Skywest Airlines Inc.,542,272,691,25,4538,6068
ABQ,LAX,Southwest Airlines Co.,1371,0,828,2,7012,9213
ABQ,LBB,Southwest Airlines Co.,257,16,39,0,920,1232
ABQ,MAF,Southwest Airlines Co.,412,0,44,0,2235,2691
ABQ,MCI,Southwest Airlines Co.,601,385,61,0,1653,2700
ABQ,MCO,Southwest Airlines Co.,454,0,154,0,571,1179
ABQ,MDW,Southwest Airlines Co.,181,199,450,0,755,1585
ABQ,OAK,Southwest Airlines Co.,1164,25,442,0,3648,5279
ABQ,ORD,American Airlines Inc.,1420,0,1826,0,389,3635
ABQ,ORD,Skywest Airlines Inc.,62,0,1645,0,232,1939
ABQ,PDX,Southwest Airlines Co.,525,33,429,0,2551,3538
ABQ,PHX,Southwest Airlines Co.,2859,116,2732,0,13986,19693
ABQ,PHX,US Airways Inc.,1072,7,454,0,652,2185
ABQ,SAN,Southwest Airlines Co.,770,58,554,0,3440,4822
ABQ,SEA,Southwest Airlines Co.,475,0,481,0,3769,4725
ABQ,SFO,Skywest Airlines Inc.,474,30,1043,0,941,2488
ABQ,SLC,Skywest Airlines Inc.,177,71,77,0,1518,1843
ABQ,SLC,Southwest Airlines Co.,438,161,113,0,2911,3623
ABQ,STL,Southwest Airlines Co.,57,0,6,0,199,262
ABQ,TPA,Southwest Airlines Co.,347,0,49,0,476,872
ABQ,TUS,Southwest Airlines Co.,693,0,255,0,4437,5385
ABY,ATL,Atlantic Southeast Airlines,3861,694,1885,0,402,6842
ACT,DFW,American Eagle Airlines Inc.,1574,1229,1281,0,4418,8502
ACV,CEC,Skywest Airlines Inc.,264,540,85,0,305,1194
ACV,SFO,Skywest Airlines Inc.,4198,319,19935,7,5581,30040
ACV,SLC,Skywest Airlines Inc.,178,0,52,0,50,280
ACV,SMF,Skywest Airlines Inc.,383,53,165,0,2264,2865
ACY,ATL,Atlantic Southeast Airlines,1063,0,812,0,0,1875
ADK,ANC,Alaska Airlines Inc.,112,0,0,0,241,353
ADQ,ANC,Alaska Airlines Inc.,330,66,125,32,1844,2397
AEX,ATL,Atlantic Southeast Airlines,4165,1294,1803,21,272,7555
AEX,DFW,American Eagle Airlines Inc.,2212,2344,848,0,2484,7888
AGS,ATL,Atlantic Southeast Airlines,5854,2917,4024,40,436,13271
AKN,DLG,Alaska Airlines Inc.,120,0,14,0,301,435
ALB,ATL,Atlantic Southeast Airlines,4164,1577,1958,11,1223,8933
ALB,BWI,Southwest Airlines Co.,1084,728,1555,19,7445,10831
ALB,CLT,US Airways Inc.,501,58,269,6,713,1547
ALB,CVG,Atlantic Southeast Airlines,0,15,0,0,0,15
ALB,DCA,US Airways Inc.,152,0,34,0,0,186
ALB,LAS,Southwest Airlines Co.,223,150,336,0,661,1370
ALB,MCO,Southwest Airlines Co.,1161,180,1087,0,2246,4674
ALB,MDW,Southwest Airlines Co.,375,624,791,0,900,2690
ALB,ORD,American Eagle Airlines Inc.,1221,184,3092,0,3552,8049
ALB,ORD,United Air Lines Inc.,1364,512,2665,0,3704,8245
ALB,PHL,US Airways Inc.,122,27,280,0,0,429
ALB,TPA,Southwest Airlines Co.,424,107,211,0,193,935
AMA,ABQ,Southwest Airlines Co.,238,338,32,18,0,626
AMA,DAL,Southwest Airlines Co.,1577,1055,746,0,7697,11075
AMA,DEN,Southwest Airlines Co.,153,80,68,0,2850,3151
AMA,DFW,American Eagle Airlines Inc.,2504,2753,1813,7,10418,17495
AMA,LAS,Southwest Airlines Co.,88,0,602,0,1339,2029
ANC,ADK,Alaska Airlines Inc.,100,48,105,0,204,457
ANC,ADQ,Alaska Airlines Inc.,890,435,186,0,489,2000
ANC,AKN,Alaska Airlines Inc.,105,0,2,0,231,338
ANC,ATL,Delta Air Lines Inc.,8,0,14,0,405,427
ANC,BET,Alaska Airlines Inc.,1606,565,366,0,788,3325
ANC,CDV,Alaska Airlines Inc.,1029,117,88,0,1499,2733
ANC,CVG,Delta Air Lines Inc.,89,0,31,0,167,287
ANC,DEN,Frontier Airlines Inc.,152,0,158,0,379,689
ANC,DEN,United Air Lines Inc.,132,9,67,0,280,488
ANC,DFW,American Airlines Inc.,501,0,123,0,606,1230
ANC,FAI,Alaska Airlines Inc.,4273,595,763,0,3433,9064
ANC,HNL,Alaska Airlines Inc.,630,0,124,0,138,892
ANC,JNU,Alaska Airlines Inc.,1599,300,259,0,1505,3663
ANC,LAS,US Airways Inc.,795,0,75,0,523,1393
ANC,LAX,Alaska Airlines Inc.,152,0,43,0,30,225
ANC,LAX,Delta Air Lines Inc.,0,0,17,0,53,70
ANC,OME,Alaska Airlines Inc.,904,227,73,0,180,1384
ANC,ORD,Alaska Airlines Inc.,342,0,68,0,125,535
ANC,ORD,United Air Lines Inc.,165,0,78,0,438,681
ANC,OTZ,Alaska Airlines Inc.,689,133,108,0,404,1334
ANC,PDX,Alaska Airlines Inc.,285,0,32,0,448,765
ANC,PHX,US Airways Inc.,517,0,91,0,537,1145
ANC,SCC,Alaska Airlines Inc.,783,162,50,0,316,1311
ANC,SEA,Alaska Airlines Inc.,5274,537,1158,9,4454,11432
ANC,SFO,United Air Lines Inc.,105,0,15,0,341,461
ANC,SLC,Delta Air Lines Inc.,156,0,59,0,196,411
ASE,ATL,Skywest Airlines Inc.,0,0,85,0,0,85
ASE,DEN,Skywest Airlines Inc.,3951,8264,1187,356,8874,22632
ASE,LAX,Skywest Airlines Inc.,1005,667,180,90,1903,3845
ASE,ORD,Skywest Airlines Inc.,1415,1099,8408,77,1672,12671
ASE,SFO,Skywest Airlines Inc.,270,0,857,0,426,1553
ASE,SLC,Skywest Airlines Inc.,1016,1813,478,188,2299,5794
ATL,ABE,Atlantic Southeast Airlines,3507,1502,958,0,165,6132
ATL,ABQ,Delta Air Lines Inc.,1866,266,745,0,1707,4584
ATL,ABY,Atlantic Southeast Airlines,4221,870,1664,18,499,7272
ATL,ACY,Atlantic Southeast Airlines,877,178,380,0,73,1508
ATL,AEX,Atlantic Southeast Airlines,3209,1584,1206,0,581,6580
ATL,AGS,Atlantic Southeast Airlines,9440,3289,1661,32,697,15119
ATL,ALB,Atlantic Southeast Airlines,4688,2465,1672,0,1247,10072
ATL,ANC,Delta Air Lines Inc.,277,0,79,0,169,525
ATL,ASE,Skywest Airlines Inc.,0,109,20,0,0,129
ATL,ATW,Atlantic Southeast Airlines,2781,1319,756,0,309,5165
ATL,AUS,Atlantic Southeast Airlines,2823,885,411,0,293,4412
ATL,AUS,Delta Air Lines Inc.,1770,394,639,0,1492,4295
ATL,AVL,Atlantic Southeast Airlines,6198,1186,1396,0,661,9441
ATL,AVP,Atlantic Southeast Airlines,3502,1334,763,0,343,5942
ATL,BDL,Atlantic Southeast Airlines,58,0,1,0,0,59
ATL,BDL,Delta Air Lines Inc.,2588,337,1523,0,2162,6610
ATL,BGR,Atlantic Southeast Airlines,2631,719,533,0,197,4080
ATL,BHM,Atlantic Southeast Airlines,2107,849,604,14,267,3841
ATL,BHM,Delta Air Lines Inc.,2662,526,704,0,3034,6926
ATL,BHM,Skywest Airlines Inc.,0,0,0,0,41,41
ATL,BMI,Atlantic Southeast Airlines,3943,2178,887,0,301,7309
ATL,BNA,Atlantic Southeast Airlines,4504,1471,955,0,462,7392
ATL,BNA,Delta Air Lines Inc.,1764,167,749,0,3413,6093
ATL,BNA,Skywest Airlines Inc.,524,0,0,0,16,540
ATL,BOI,Delta Air Lines Inc.,54,0,97,0,35,186
ATL,BOS,Delta Air Lines Inc.,5352,749,4589,0,3704,14394
ATL,BQK,Atlantic Southeast Airlines,2578,2047,1091,0,346,6062
ATL,BTR,Atlantic Southeast Airlines,11223,3559,4737,0,1281,20800
ATL,BTV,Atlantic Southeast Airlines,1606,314,171,0,234,2325
ATL,BUF,Atlantic Southeast Airlines,2836,503,466,0,243,4048
ATL,BUF,Delta Air Lines Inc.,1376,391,1037,0,1424,4228
ATL,BUF,Skywest Airlines Inc.,1620,320,356,46,149,2491
ATL,BWI,Atlantic Southeast Airlines,88,0,0,0,0,88
ATL,BWI,Delta Air Lines Inc.,4826,361,2377,0,3639,11203
ATL,BZN,Delta Air Lines Inc.,28,0,41,0,188,257
ATL,CAE,Atlantic Southeast Airlines,5498,2368,1521,14,850,10251
ATL,CAE,Delta Air Lines Inc.,706,72,323,0,2236,3337
ATL,CAK,Atlantic Southeast Airlines,8183,2736,1621,7,943,13490
ATL,CHA,Atlantic Southeast Airlines,7710,2399,1840,0,765,12714
ATL,CHO,Atlantic Southeast Airlines,2643,958,1072,0,245,4918
ATL,CHS,Atlantic Southeast Airlines,3222,551,840,66,275,4954
ATL,CHS,Delta Air Lines Inc.,2752,424,1689,0,4131,8996
ATL,CID,Atlantic Southeast Airlines,1222,507,415,0,99,2243
ATL,CLE,Atlantic Southeast Airlines,7002,1713,1953,0,584,11252
ATL,CLE,Delta Air Lines Inc.,592,91,802,0,956,2441
ATL,CLE,Skywest Airlines Inc.,21,0,0,0,0,21
ATL,CLT,Atlantic Southeast Airlines,1911,560,1175,8,233,3887
ATL,CLT,Delta Air Lines Inc.,3776,387,2235,0,3293,9691
ATL,CLT,US Airways Inc.,715,139,400,0,837,2091
ATL,CMH,Atlantic Southeast Airlines,452,0,81,0,172,705
ATL,CMH,Delta Air Lines Inc.,762,85,234,0,992,2073
ATL,CMH,Skywest Airlines Inc.,717,28,62,0,488,1295
ATL,COS,Delta Air Lines Inc.,183,7,103,0,182,475
ATL,COS,Skywest Airlines Inc.,2035,206,480,0,1221,3942
ATL,CRP,Atlantic Southeast Airlines,40,0,0,0,0,40
ATL,CRW,Atlantic Southeast Airlines,5216,1765,1277,0,645,8903
ATL,CSG,Atlantic Southeast Airlines,5357,1655,1667,0,607,9286
ATL,CVG,Atlantic Southeast Airlines,2028,379,574,0,131,3112
ATL,CVG,Delta Air Lines Inc.,2467,308,1079,0,1845,5699
ATL,CVG,Skywest Airlines Inc.,674,222,112,0,666,1674
ATL,DAB,Atlantic Southeast Airlines,2470,741,670,0,408,4289
ATL,DAB,Delta Air Lines Inc.,2441,277,762,0,2702,6182
ATL,DAY,Atlantic Southeast Airlines,5700,1866,1160,0,415,9141
ATL,DAY,Delta Air Lines Inc.,1641,231,531,0,2323,4726
ATL,DCA,Atlantic Southeast Airlines,0,78,0,0,0,78
ATL,DCA,Delta Air Lines Inc.,5739,1051,3439,66,4905,15200
ATL,DEN,Delta Air Lines Inc.,4422,788,2167,0,2701,10078
ATL,DEN,Frontier Airlines Inc.,1438,36,2256,0,1599,5329
ATL,DEN,United Air Lines Inc.,1382,77,276,0,259,1994
ATL,DFW,American Airlines Inc.,7365,1032,5268,0,13525,27190
ATL,DFW,Atlantic Southeast Airlines,90,0,10,0,0,100
ATL,DFW,Delta Air Lines Inc.,4793,766,3579,0,4049,13187
ATL,DFW,Skywest Airlines Inc.,404,0,165,0,7,576
ATL,DHN,Atlantic Southeast Airlines,4874,1695,1542,16,332,8459
ATL,DSM,Atlantic Southeast Airlines,3855,1514,715,0,426,6510
ATL,DTW,Atlantic Southeast Airlines,5224,500,878,20,345,6967
ATL,DTW,Delta Air Lines Inc.,1792,394,778,0,1149,4113
ATL,DTW,Skywest Airlines Inc.,251,107,38,0,312,708
ATL,EGE,Delta Air Lines Inc.,333,0,231,0,16,580
ATL,ELP,Delta Air Lines Inc.,1539,60,540,0,799,2938
ATL,EVV,Atlantic Southeast Airlines,3792,1219,1335,0,141,6487
ATL,EWN,Atlantic Southeast Airlines,2634,602,737,0,234,4207
ATL,EWR,Atlantic Southeast Airlines,1787,907,2282,0,453,5429
ATL,EWR,Delta Air Lines Inc.,3701,990,15624,0,3326,23641
ATL,EYW,Atlantic Southeast Airlines,6131,2419,965,0,1006,10521
ATL,FAY,Atlantic Southeast Airlines,8773,2587,3060,90,769,15279
ATL,FLL,Delta Air Lines Inc.,5981,749,3766,0,5094,15590
ATL,FLO,Atlantic Southeast Airlines,1971,462,535,0,257,3225
ATL,FNT,Atlantic Southeast Airlines,5598,2341,1464,0,478,9881
ATL,FSD,Atlantic Southeast Airlines,414,199,21,0,104,738
ATL,FSM,Atlantic Southeast Airlines,2141,1084,747,0,227,4199
ATL,FWA,Atlantic Southeast Airlines,4721,672,1184,0,348,6925
ATL,GNV,Atlantic Southeast Airlines,7983,2610,2011,0,1036,13640
ATL,GPT,Atlantic Southeast Airlines,7763,3096,2084,0,1093,14036
ATL,GPT,Delta Air Lines Inc.,604,23,330,0,600,1557
ATL,GRB,Atlantic Southeast Airlines,1011,268,359,0,142,1780
ATL,GRK,Atlantic Southeast Airlines,2379,828,313,0,140,3660
ATL,GRR,Atlantic Southeast Airlines,4376,1781,997,0,482,7636
ATL,GSO,Atlantic Southeast Airlines,5460,625,976,0,769,7830
ATL,GSO,Delta Air Lines Inc.,600,42,300,0,931,1873
ATL,GSP,Atlantic Southeast Airlines,4930,1778,1336,32,543,8619
ATL,GSP,Delta Air Lines Inc.,276,0,116,0,172,564
ATL,GSP,Skywest Airlines Inc.,841,61,84,0,845,1831
ATL,GTR,Atlantic Southeast Airlines,2939,1512,806,0,546,5803
ATL,HDN,Delta Air Lines Inc.,402,0,177,0,213,792
ATL,HHH,Atlantic Southeast Airlines,4826,1607,1325,63,155,7976
ATL,HNL,Delta Air Lines Inc.,3147,183,1299,0,924,5553
ATL,HOU,Atlantic Southeast Airlines,847,69,184,0,60,1160
ATL,HOU,Delta Air Lines Inc.,193,12,307,0,291,803
ATL,HOU,Skywest Airlines Inc.,18,0,0,0,128,146
ATL,HPN,Atlantic Southeast Airlines,4317,1477,1739,0,325,7858
ATL,HSV,Atlantic Southeast Airlines,4174,1157,1071,0,581,6983
ATL,HSV,Delta Air Lines Inc.,600,184,538,0,576,1898
ATL,HSV,Skywest Airlines Inc.,206,0,143,98,335,782
ATL,IAD,Atlantic Southeast Airlines,1513,516,295,0,205,2529
ATL,IAD,Delta Air Lines Inc.,3678,651,1477,0,2602,8408
ATL,IAH,Atlantic Southeast Airlines,137,0,0,0,0,137
ATL,IAH,Delta Air Lines Inc.,1841,101,1370,0,1665,4977
ATL,IAH,Skywest Airlines Inc.,1149,487,588,28,285,2537
ATL,ICT,Atlantic Southeast Airlines,7335,2875,2135,25,648,13018
ATL,ILM,Atlantic Southeast Airlines,5841,2556,2023,0,548,10968
ATL,IND,Atlantic Southeast Airlines,3981,898,694,0,465,6038
ATL,IND,Delta Air Lines Inc.,1910,195,679,0,1585,4369
ATL,ISP,Atlantic Southeast Airlines,1846,709,524,0,223,3302
ATL,JAC,Delta Air Lines Inc.,26,6,33,0,172,237
ATL,JAN,Atlantic Southeast Airlines,6881,1952,2099,0,815,11747
ATL,JAN,Delta Air Lines Inc.,1227,181,305,0,1474,3187
ATL,JAX,Delta Air Lines Inc.,4969,945,1980,0,3584,11478
ATL,JFK,Atlantic Southeast Airlines,125,0,0,0,0,125
ATL,JFK,Delta Air Lines Inc.,3144,432,3329,0,925,7830
ATL,LAS,Delta Air Lines Inc.,6854,876,4393,0,3103,15226
ATL,LAS,US Airways Inc.,751,33,654,7,1507,2952
ATL,LAW,Atlantic Southeast Airlines,1602,896,288,0,67,2853
ATL,LAX,Delta Air Lines Inc.,10892,770,6351,0,4479,22492
ATL,LEX,Atlantic Southeast Airlines,3458,1687,492,0,265,5902
ATL,LEX,Delta Air Lines Inc.,561,26,344,0,664,1595
ATL,LFT,Atlantic Southeast Airlines,4001,1512,1237,0,106,6856
ATL,LGA,American Airlines Inc.,1071,75,5796,0,4687,11629
ATL,LGA,Delta Air Lines Inc.,7876,446,15334,0,5218,28874
ATL,LIT,Atlantic Southeast Airlines,8880,2078,2105,0,1267,14330
ATL,LIT,Delta Air Lines Inc.,601,462,283,0,1069,2415
ATL,LWB,Atlantic Southeast Airlines,613,60,81,0,0,754
ATL,LYH,Atlantic Southeast Airlines,2099,772,604,0,256,3731
ATL,MCI,Atlantic Southeast Airlines,1894,596,357,0,172,3019
ATL,MCI,Delta Air Lines Inc.,3199,819,1166,0,2738,7922
ATL,MCN,Atlantic Southeast Airlines,4729,1854,619,0,279,7481
ATL,MCO,Delta Air Lines Inc.,8825,1077,3737,0,6745,20384
ATL,MDT,Atlantic Southeast Airlines,6294,2523,3260,76,379,12532
ATL,MDW,Atlantic Southeast Airlines,95,102,2,0,0,199
ATL,MEI,Atlantic Southeast Airlines,2413,835,528,0,643,4419
ATL,MEM,Atlantic Southeast Airlines,2867,477,909,0,161,4414
ATL,MEM,Delta Air Lines Inc.,1826,329,715,0,1831,4701
ATL,MEM,Skywest Airlines Inc.,355,0,168,0,39,562
ATL,MFE,Atlantic Southeast Airlines,66,0,0,0,32,98
ATL,MGM,Atlantic Southeast Airlines,6533,2955,2382,0,571,12441
ATL,MHT,Atlantic Southeast Airlines,2188,77,462,0,341,3068
ATL,MIA,American Airlines Inc.,3694,329,2064,0,5225,11312
ATL,MIA,Delta Air Lines Inc.,4977,471,1955,0,2996,10399
ATL,MKE,Atlantic Southeast Airlines,7579,1552,1507,22,646,11306
ATL,MKE,Delta Air Lines Inc.,597,215,399,0,789,2000
ATL,MKE,Skywest Airlines Inc.,533,0,328,0,571,1432
ATL,MLB,Atlantic Southeast Airlines,4217,1307,1036,0,484,7044
ATL,MLB,Delta Air Lines Inc.,941,180,549,0,1619,3289
ATL,MLI,Atlantic Southeast Airlines,4448,1494,1561,0,484,7987
ATL,MLU,Atlantic Southeast Airlines,3048,863,1113,41,492,5557
ATL,MOB,Atlantic Southeast Airlines,5265,1336,1278,0,159,8038
ATL,MOB,Delta Air Lines Inc.,877,59,192,0,1030,2158
ATL,MOB,Skywest Airlines Inc.,0,0,0,0,50,50
ATL,MSN,Atlantic Southeast Airlines,1340,447,295,0,46,2128
ATL,MSP,Atlantic Southeast Airlines,1954,786,728,0,138,3606
ATL,MSP,Delta Air Lines Inc.,2307,148,640,0,1542,4637
ATL,MSP,Skywest Airlines Inc.,621,101,217,99,76,1114
ATL,MSY,Atlantic Southeast Airlines,474,0,5,0,18,497
ATL,MSY,Delta Air Lines Inc.,3765,510,1453,0,3875,9603
ATL,MTJ,Delta Air Lines Inc.,70,4,50,0,64,188
ATL,MTJ,Skywest Airlines Inc.,75,0,0,38,0,113
ATL,MYR,Atlantic Southeast Airlines,9629,2442,1570,0,749,14390
ATL,OAJ,Atlantic Southeast Airlines,3800,1056,1210,0,433,6499
ATL,OAK,Delta Air Lines Inc.,402,90,456,0,196,1144
ATL,OKC,Atlantic Southeast Airlines,6617,1408,1614,0,423,10062
ATL,OKC,Delta Air Lines Inc.,510,101,286,0,549,1446
ATL,OKC,Skywest Airlines Inc.,423,0,198,0,49,670
ATL,OMA,Atlantic Southeast Airlines,6664,1886,1815,19,382,10766
ATL,OMA,Skywest Airlines Inc.,366,217,355,0,405,1343
ATL,ONT,Delta Air Lines Inc.,2024,521,846,0,968,4359
ATL,ORD,American Airlines Inc.,1611,125,7018,0,5569,14323
ATL,ORD,American Eagle Airlines Inc.,896,94,4067,0,6527,11584
ATL,ORD,Atlantic Southeast Airlines,25,0,4,0,0,29
ATL,ORD,Delta Air Lines Inc.,4300,737,8230,0,3395,16662
ATL,ORD,Skywest Airlines Inc.,1088,357,1038,0,492,2975
ATL,ORD,United Air Lines Inc.,3099,667,11699,0,7668,23133
ATL,ORF,Atlantic Southeast Airlines,3631,953,617,0,198,5399
ATL,ORF,Delta Air Lines Inc.,2527,580,641,0,2552,6300
ATL,PBI,Delta Air Lines Inc.,5503,1368,2017,0,3478,12366
ATL,PDX,Delta Air Lines Inc.,1760,233,562,0,833,3388
ATL,PFN,Atlantic Southeast Airlines,12250,3431,2791,16,643,19131
ATL,PHF,Atlantic Southeast Airlines,8698,2094,1646,0,501,12939
ATL,PHF,Delta Air Lines Inc.,153,0,169,0,352,674
ATL,PHL,Atlantic Southeast Airlines,426,437,506,0,33,1402
ATL,PHL,Delta Air Lines Inc.,4149,295,7078,0,3391,14913
ATL,PHL,US Airways Inc.,1087,437,3226,0,1537,6287
ATL,PHX,Delta Air Lines Inc.,4485,529,2672,0,3743,11429
ATL,PHX,US Airways Inc.,2385,142,776,65,1812,5180
ATL,PIA,Atlantic Southeast Airlines,3694,1102,812,0,196,5804
ATL,PIT,Atlantic Southeast Airlines,1231,566,147,0,263,2207
ATL,PIT,Delta Air Lines Inc.,2982,212,840,0,2082,6116
ATL,PIT,Skywest Airlines Inc.,228,38,198,0,0,464
ATL,PNS,Atlantic Southeast Airlines,2787,823,516,0,418,4544
ATL,PNS,Delta Air Lines Inc.,3318,401,1014,0,2729,7462
ATL,PVD,Atlantic Southeast Airlines,4910,1871,1446,19,396,8642
ATL,PWM,Atlantic Southeast Airlines,4306,1053,1415,0,693,7467
ATL,RDU,Atlantic Southeast Airlines,710,254,136,0,32,1132
ATL,RDU,Delta Air Lines Inc.,4955,319,1738,0,3096,10108
ATL,RIC,Atlantic Southeast Airlines,2187,426,520,0,87,3220
ATL,RIC,Delta Air Lines Inc.,2402,446,742,0,1894,5484
ATL,RNO,Delta Air Lines Inc.,572,300,420,0,398,1690
ATL,ROA,Atlantic Southeast Airlines,3887,2080,1344,0,542,7853
ATL,ROC,Atlantic Southeast Airlines,2962,852,1104,0,395,5313
ATL,ROC,Delta Air Lines Inc.,866,342,228,0,1208,2644
ATL,RSW,Delta Air Lines Inc.,3840,619,967,0,2873,8299
ATL,SAN,Delta Air Lines Inc.,4899,531,2110,0,2183,9723
ATL,SAT,Atlantic Southeast Airlines,4848,1628,1105,0,319,7900
ATL,SAT,Delta Air Lines Inc.,2534,641,1427,0,3297,7899
ATL,SAV,Atlantic Southeast Airlines,444,254,17,0,281,996
ATL,SAV,Delta Air Lines Inc.,3592,341,1680,0,4586,10199
ATL,SBN,Atlantic Southeast Airlines,3263,1307,938,0,267,5775
ATL,SCE,Atlantic Southeast Airlines,1025,261,166,0,75,1527
ATL,SDF,Atlantic Southeast Airlines,3873,939,1075,0,561,6448
ATL,SDF,Delta Air Lines Inc.,1735,370,612,0,2152,4869
ATL,SEA,Delta Air Lines Inc.,2685,455,1353,0,2022,6515
ATL,SFO,Delta Air Lines Inc.,4196,569,5536,0,3467,13768
ATL,SFO,United Air Lines Inc.,955,19,368,0,0,1342
ATL,SGF,Atlantic Southeast Airlines,2871,1220,746,0,286,5123
ATL,SHV,Atlantic Southeast Airlines,5892,3202,2214,13,691,12012
ATL,SJC,Delta Air Lines Inc.,1760,218,818,0,901,3697
ATL,SJU,Delta Air Lines Inc.,2789,517,1245,0,2117,6668
ATL,SLC,Delta Air Lines Inc.,6560,864,3220,0,3269,13913
ATL,SMF,Delta Air Lines Inc.,1985,201,862,0,1046,4094
ATL,SNA,Delta Air Lines Inc.,1898,151,1033,0,965,4047
ATL,SRQ,Atlantic Southeast Airlines,2422,258,476,0,319,3475
ATL,SRQ,Delta Air Lines Inc.,2525,446,1205,0,3305,7481
ATL,STL,Atlantic Southeast Airlines,4245,917,1573,0,211,6946
ATL,STL,Delta Air Lines Inc.,2585,284,830,0,2411,6110
ATL,STL,Skywest Airlines Inc.,252,0,21,0,0,273
ATL,STT,Delta Air Lines Inc.,422,48,216,0,321,1007
ATL,STX,Delta Air Lines Inc.,3,0,0,0,43,46
ATL,SWF,Atlantic Southeast Airlines,5819,1705,2006,0,407,9937
ATL,SYR,Atlantic Southeast Airlines,5060,924,1497,23,170,7674
ATL,TLH,Atlantic Southeast Airlines,5599,1613,1447,0,715,9374
ATL,TLH,Delta Air Lines Inc.,1339,153,315,0,1857,3664
ATL,TOL,Atlantic Southeast Airlines,548,132,55,0,40,775
ATL,TPA,Delta Air Lines Inc.,5231,1065,2486,0,4375,13157
ATL,TRI,Atlantic Southeast Airlines,6679,1978,1161,0,421,10239
ATL,TUL,Atlantic Southeast Airlines,7770,2677,2393,0,681,13521
ATL,TUL,Skywest Airlines Inc.,628,354,202,0,341,1525
ATL,TUS,Delta Air Lines Inc.,1455,122,555,38,1187,3357
ATL,TYS,Atlantic Southeast Airlines,6541,1897,2109,0,482,11029
ATL,TYS,Delta Air Lines Inc.,1000,51,360,0,666,2077
ATL,VLD,Atlantic Southeast Airlines,3734,1010,1570,20,511,6845
ATL,VPS,Atlantic Southeast Airlines,12900,3471,3619,0,1391,21381
ATL,VPS,Delta Air Lines Inc.,544,2,311,0,729,1586
ATL,XNA,Atlantic Southeast Airlines,4694,1600,937,0,1201,8432
ATL,XNA,Skywest Airlines Inc.,567,164,59,0,354,1144
ATW,ATL,Atlantic Southeast Airlines,3652,438,1353,0,426,5869
ATW,DSM,Skywest Airlines Inc.,0,210,0,0,0,210
ATW,MKE,Skywest Airlines Inc.,1959,656,247,0,426,3288
ATW,ORD,Skywest Airlines Inc.,421,1121,5498,0,4020,11060
AUS,ATL,Atlantic Southeast Airlines,1911,417,903,0,232,3463
AUS,ATL,Delta Air Lines Inc.,1455,225,1051,0,2020,4751
AUS,BNA,Southwest Airlines Co.,359,31,82,0,2487,2959
AUS,BOS,JetBlue Airways,266,0,566,0,1124,1956
AUS,BWI,Southwest Airlines Co.,364,79,568,0,1316,2327
AUS,DAL,American Eagle Airlines Inc.,1424,780,1195,0,10000,13399
AUS,DAL,Southwest Airlines Co.,3283,1776,1863,17,10051,16990
AUS,DEN,Frontier Airlines Inc.,929,0,770,0,933,2632
AUS,DEN,Skywest Airlines Inc.,49,0,37,0,69,155
AUS,DEN,Southwest Airlines Co.,552,34,281,0,2393,3260
AUS,DEN,United Air Lines Inc.,1448,58,345,0,2247,4098
AUS,DFW,American Airlines Inc.,2737,2270,4496,14,11079,20596
AUS,DSM,Skywest Airlines Inc.,0,100,0,0,0,100
AUS,ELP,Southwest Airlines Co.,1650,18,212,0,3973,5853
AUS,FLL,JetBlue Airways,141,0,4,0,0,145
AUS,FLL,Southwest Airlines Co.,210,0,0,0,7,217
AUS,HOU,Southwest Airlines Co.,1721,974,2428,9,7031,12163
AUS,HRL,Southwest Airlines Co.,265,0,78,0,1142,1485
AUS,JFK,JetBlue Airways,193,0,2399,0,1946,4538
AUS,LAS,Southwest Airlines Co.,571,66,563,0,3485,4685
AUS,LAX,American Airlines Inc.,1680,90,720,0,1861,4351
AUS,LAX,Skywest Airlines Inc.,231,0,20,0,615,866
AUS,LAX,Southwest Airlines Co.,569,32,388,0,948,1937
AUS,LBB,Southwest Airlines Co.,464,261,121,0,2249,3095
AUS,LGB,JetBlue Airways,42,0,70,0,95,207
AUS,MAF,Southwest Airlines Co.,276,74,102,0,1969,2421
AUS,MCI,Skywest Airlines Inc.,1835,194,87,0,747,2863
AUS,MCO,JetBlue Airways,27,0,42,0,407,476
AUS,MCO,Southwest Airlines Co.,32,95,59,0,359,545
AUS,MDW,Southwest Airlines Co.,865,298,318,0,1691,3172
AUS,MSY,Skywest Airlines Inc.,0,82,0,0,0,82
AUS,OAK,Southwest Airlines Co.,298,12,227,0,528,1065
AUS,ORD,American Airlines Inc.,1767,94,9397,0,5591,16849
AUS,ORD,Skywest Airlines Inc.,398,0,5099,0,1133,6630
AUS,PHL,Southwest Airlines Co.,152,165,552,0,59,928
AUS,PHX,Southwest Airlines Co.,919,78,546,0,4921,6464
AUS,PHX,US Airways Inc.,498,5,176,0,254,933
AUS,RDU,American Airlines Inc.,403,8,63,0,714,1188
AUS,SAN,Southwest Airlines Co.,619,5,387,0,1827,2838
AUS,SEA,American Airlines Inc.,277,0,93,0,0,370
AUS,SFO,JetBlue Airways,9,0,68,0,126,203
AUS,SFO,United Air Lines Inc.,720,0,207,0,96,1023
AUS,SJC,American Airlines Inc.,1371,285,457,7,1688,3808
AUS,SLC,Skywest Airlines Inc.,529,17,448,0,329,1323
AUS,SNA,American Airlines Inc.,893,0,114,0,0,1007
AUS,STL,American Airlines Inc.,230,21,78,0,896,1225
AUS,TPA,Southwest Airlines Co.,240,0,64,0,570,874
AVL,ATL,Atlantic Southeast Airlines,4330,2079,2286,23,326,9044
AVL,CVG,Atlantic Southeast Airlines,0,8,0,0,9,17
AVL,MCO,Atlantic Southeast Airlines,238,0,99,0,1,338
AVP,ATL,Atlantic Southeast Airlines,2858,1121,1080,30,277,5366
AVP,ORD,Skywest Airlines Inc.,223,0,1551,7,364,2145
AZO,CVG,Atlantic Southeast Airlines,20,42,0,0,0,62
AZO,FAR,Skywest Airlines Inc.,24,0,12,0,0,36
AZO,ORD,American Eagle Airlines Inc.,2645,503,5746,0,5480,14374
AZO,ORD,Skywest Airlines Inc.,509,0,7981,0,2523,11013
BDL,ATL,Atlantic Southeast Airlines,36,0,0,0,0,36
BDL,ATL,Delta Air Lines Inc.,1763,348,2443,0,2856,7410
BDL,BNA,Southwest Airlines Co.,336,515,277,0,1076,2204
BDL,BWI,Southwest Airlines Co.,1933,1653,1600,11,8874,14071
BDL,CLT,US Airways Inc.,1966,521,932,0,1252,4671
BDL,CVG,Delta Air Lines Inc.,630,145,242,0,961,1978
BDL,DCA,US Airways Inc.,563,356,210,0,792,1921
BDL,DEN,Frontier Airlines Inc.,157,33,296,0,457,943
BDL,DFW,American Airlines Inc.,982,331,2219,96,2617,6245
BDL,FLL,Delta Air Lines Inc.,566,154,712,0,1987,3419
BDL,IAD,United Air Lines Inc.,1332,486,1630,0,5239,8687
BDL,LAS,Southwest Airlines Co.,187,229,111,0,0,527
BDL,LAX,Delta Air Lines Inc.,676,35,443,0,856,2010
BDL,MCO,Delta Air Lines Inc.,513,39,728,0,1213,2493
BDL,MCO,Southwest Airlines Co.,1266,104,1222,11,3214,5817
BDL,MDW,Southwest Airlines Co.,704,694,1006,0,2022,4426
BDL,MIA,American Airlines Inc.,188,40,132,22,0,382
BDL,MKE,Skywest Airlines Inc.,3018,1123,313,0,55,4509
BDL,ORD,American Eagle Airlines Inc.,1345,459,7150,62,6956,15972
BDL,ORD,United Air Lines Inc.,3160,50,4049,0,3620,10879
BDL,PBI,Delta Air Lines Inc.,1453,148,525,0,160,2286
BDL,PHL,US Airways Inc.,1103,128,1153,0,142,2526
BDL,PHX,US Airways Inc.,201,260,134,0,0,595
BDL,RDU,American Eagle Airlines Inc.,1423,193,628,56,1766,4066
BDL,RSW,Delta Air Lines Inc.,411,34,203,0,1116,1764
BDL,SJU,American Airlines Inc.,1711,285,460,24,0,2480
BDL,TPA,Delta Air Lines Inc.,944,464,565,0,1656,3629
BDL,TPA,Southwest Airlines Co.,739,25,335,0,2449,3548
BET,ANC,Alaska Airlines Inc.,625,196,152,91,2783,3847
BFL,DEN,Skywest Airlines Inc.,253,0,253,15,232,753
BFL,LAX,Skywest Airlines Inc.,392,0,378,0,880,1650
BFL,SFO,Skywest Airlines Inc.,1222,269,5294,10,3015,9810
BFL,SLC,Skywest Airlines Inc.,265,129,0,0,339,733
BGR,ATL,Atlantic Southeast Airlines,2375,346,502,16,344,3583
BHM,ATL,Atlantic Southeast Airlines,1287,1731,1177,0,328,4523
BHM,ATL,Delta Air Lines Inc.,2473,0,1603,0,1616,5692
BHM,BNA,Southwest Airlines Co.,210,63,280,0,1921,2474
BHM,BWI,Southwest Airlines Co.,730,1240,584,0,3155,5709
BHM,DAL,Southwest Airlines Co.,479,11,353,0,3177,4020
BHM,DEN,Skywest Airlines Inc.,1347,182,1045,21,2335,4930
BHM,DFW,American Airlines Inc.,1609,6,1032,0,4578,7225
BHM,HOU,Southwest Airlines Co.,1179,92,450,0,3481,5202
BHM,JAX,Southwest Airlines Co.,119,116,67,0,729,1031
BHM,LAS,Southwest Airlines Co.,105,103,352,0,622,1182
BHM,MCO,Southwest Airlines Co.,238,16,221,0,2476,2951
BHM,MDW,Southwest Airlines Co.,643,341,322,0,943,2249
BHM,MSY,Southwest Airlines Co.,671,29,291,0,5092,6083
BHM,ORD,American Eagle Airlines Inc.,2074,120,3712,10,4243,10159
BHM,ORD,Skywest Airlines Inc.,1710,0,8343,0,503,10556
BHM,PHX,Southwest Airlines Co.,103,0,123,0,735,961
BHM,SDF,Southwest Airlines Co.,295,205,96,0,2712,3308
BHM,SLC,Skywest Airlines Inc.,0,0,36,0,301,337
BHM,STL,Southwest Airlines Co.,57,29,47,0,172,305
BHM,TPA,Southwest Airlines Co.,1118,118,336,0,5466,7038
BIL,DEN,Skywest Airlines Inc.,222,46,128,0,574,970
BIL,DEN,United Air Lines Inc.,1077,0,387,0,3166,4630
BIL,ORD,Skywest Airlines Inc.,41,0,1119,0,58,1218
BIL,SLC,Skywest Airlines Inc.,922,374,304,15,1838,3453
BIS,DEN,Skywest Airlines Inc.,790,432,450,0,2434,4106
BLI,SLC,Skywest Airlines Inc.,0,139,0,0,0,139
BMI,ATL,Atlantic Southeast Airlines,4416,988,1981,0,257,7642
BMI,ORD,American Eagle Airlines Inc.,259,87,3579,0,3627,7552
BMI,ORD,Skywest Airlines Inc.,261,0,2409,0,376,3046
BNA,ATL,Atlantic Southeast Airlines,3207,1961,2242,0,1360,8770
BNA,ATL,Delta Air Lines Inc.,1147,0,1710,0,2122,4979
BNA,ATL,Skywest Airlines Inc.,22,0,0,0,122,144
BNA,AUS,Southwest Airlines Co.,1431,153,253,4,6540,8381
BNA,BDL,Southwest Airlines Co.,746,97,132,0,1165,2140
BNA,BHM,Southwest Airlines Co.,1021,0,141,0,2159,3321
BNA,BWI,Southwest Airlines Co.,2938,837,1474,8,5826,11083
BNA,CLE,Southwest Airlines Co.,669,71,167,0,3472,4379
BNA,CLT,US Airways Inc.,616,29,255,0,957,1857
BNA,CMH,Southwest Airlines Co.,1036,78,72,0,2988,4174
BNA,CVG,Atlantic Southeast Airlines,144,153,0,0,0,297
BNA,DCA,American Eagle Airlines Inc.,1479,47,621,0,3112,5259
BNA,DEN,Frontier Airlines Inc.,913,49,1088,0,1373,3423
BNA,DEN,Skywest Airlines Inc.,1667,135,829,26,3642,6299
BNA,DEN,Southwest Airlines Co.,912,0,302,0,3349,4563
BNA,DFW,American Airlines Inc.,5963,678,2580,0,6536,15757
BNA,DTW,Southwest Airlines Co.,1217,262,343,0,3675,5497
BNA,FLL,Southwest Airlines Co.,1010,57,612,0,2712,4391
BNA,HOU,Southwest Airlines Co.,1799,62,1076,0,6571,9508
BNA,IAD,American Airlines Inc.,0,0,0,0,57,57
BNA,JAX,Southwest Airlines Co.,2006,7,702,0,6894,9609
BNA,JFK,JetBlue Airways,0,0,0,0,19,19
BNA,LAS,Southwest Airlines Co.,1127,370,1296,0,2812,5605
BNA,LAX,American Airlines Inc.,1176,0,670,0,1607,3453
BNA,LAX,Southwest Airlines Co.,1147,11,1077,0,3397,5632
BNA,LGA,American Airlines Inc.,1283,371,6634,0,3937,12225
BNA,MCI,Southwest Airlines Co.,1331,147,625,35,5356,7494
BNA,MCO,Southwest Airlines Co.,1832,31,456,8,5137,7464
BNA,MDW,Southwest Airlines Co.,3245,1047,2452,6,9016,15766
BNA,MIA,American Airlines Inc.,394,204,200,0,1090,1888
BNA,MKE,Skywest Airlines Inc.,2147,912,268,0,860,4187
BNA,MSY,Southwest Airlines Co.,1230,43,336,0,3710,5319
BNA,OAK,Southwest Airlines Co.,283,31,647,0,1483,2444
BNA,ONT,Southwest Airlines Co.,648,21,413,0,1442,2524
BNA,ORD,American Airlines Inc.,1033,42,425,0,0,1500
BNA,ORD,American Eagle Airlines Inc.,2010,1101,10682,0,16782,30575
BNA,ORD,Skywest Airlines Inc.,918,19,6208,0,541,7686
BNA,ORF,Southwest Airlines Co.,287,167,53,0,221,728
BNA,PHL,Southwest Airlines Co.,837,991,3226,0,2408,7462
BNA,PHX,Southwest Airlines Co.,1102,82,716,6,3633,5539
BNA,PVD,Southwest Airlines Co.,432,285,196,0,1401,2314
BNA,RDU,Southwest Airlines Co.,2531,76,554,0,4388,7549
BNA,SAN,Southwest Airlines Co.,408,169,495,0,2190,3262
BNA,SAT,Southwest Airlines Co.,1049,0,477,0,3167,4693
BNA,SEA,Southwest Airlines Co.,554,0,329,0,1749,2632
BNA,SLC,Skywest Airlines Inc.,295,115,6,0,621,1037
BNA,STL,American Eagle Airlines Inc.,240,0,126,0,999,1365
BNA,TPA,Southwest Airlines Co.,2118,201,412,9,6850,9590
BOI,DEN,Frontier Airlines Inc.,54,0,88,0,114,256
BOI,DEN,Skywest Airlines Inc.,236,0,245,0,3812,4293
BOI,DEN,United Air Lines Inc.,2166,50,316,0,1916,4448
BOI,GEG,Southwest Airlines Co.,520,232,253,0,4264,5269
BOI,LAS,Southwest Airlines Co.,656,12,583,0,1863,3114
BOI,LAX,Skywest Airlines Inc.,295,17,236,0,2996,3544
BOI,OAK,Southwest Airlines Co.,493,0,24,0,753,1270
BOI,ORD,Skywest Airlines Inc.,282,15,7774,0,1132,9203
BOI,ORD,United Air Lines Inc.,229,0,510,0,567,1306
BOI,PDX,Southwest Airlines Co.,574,32,147,13,2788,3554
BOI,PHX,US Airways Inc.,1500,0,125,0,457,2082
BOI,PIT,Skywest Airlines Inc.,0,0,0,0,29,29
BOI,RNO,Southwest Airlines Co.,389,7,139,113,2772,3420
BOI,SEA,Alaska Airlines Inc.,228,0,26,0,303,557
BOI,SEA,Southwest Airlines Co.,271,35,301,0,4043,4650
BOI,SFO,Skywest Airlines Inc.,1152,0,12489,0,6933,20574
BOI,SLC,Delta Air Lines Inc.,149,197,118,48,340,852
BOI,SLC,Skywest Airlines Inc.,357,285,170,0,2289,3101
BOI,SLC,Southwest Airlines Co.,207,0,379,69,1714,2369
BOS,ATL,Delta Air Lines Inc.,4390,357,4852,48,5085,14732
BOS,AUS,JetBlue Airways,687,0,402,0,606,1695
BOS,BUF,JetBlue Airways,882,27,480,0,3937,5326
BOS,CLT,JetBlue Airways,896,0,889,0,2630,4415
BOS,CLT,US Airways Inc.,3748,780,3621,149,3039,11337
BOS,CMH,American Eagle Airlines Inc.,1065,95,1229,0,4427,6816
BOS,CMH,JetBlue Airways,46,0,0,0,0,46
BOS,CVG,Atlantic Southeast Airlines,0,25,27,0,0,52
BOS,CVG,Delta Air Lines Inc.,1571,14,496,42,408,2531
BOS,DCA,American Eagle Airlines Inc.,1882,225,1627,0,3428,7162
BOS,DCA,Atlantic Southeast Airlines,30,0,28,0,67,125
BOS,DCA,US Airways Inc.,2300,1199,2247,15,3068,8829
BOS,DEN,JetBlue Airways,467,0,318,0,2036,2821
BOS,DEN,United Air Lines Inc.,2309,286,1900,0,5038,9533
BOS,DFW,American Airlines Inc.,3721,900,2506,0,6303,13430
BOS,FLL,Delta Air Lines Inc.,2325,207,1624,0,4806,8962
BOS,FLL,JetBlue Airways,2127,35,1978,0,5683,9823
BOS,IAD,JetBlue Airways,1810,38,1213,0,2393,5454
BOS,IAD,United Air Lines Inc.,2562,365,2464,0,3091,8482
BOS,JAX,JetBlue Airways,504,0,202,0,1146,1852
BOS,JFK,American Eagle Airlines Inc.,1795,67,6184,0,5434,13480
BOS,JFK,Delta Air Lines Inc.,773,58,3127,0,980,4938
BOS,JFK,JetBlue Airways,2567,0,8190,0,5317,16074
BOS,LAS,Delta Air Lines Inc.,271,0,384,0,192,847
BOS,LAS,JetBlue Airways,195,0,336,0,1435,1966
BOS,LAS,US Airways Inc.,951,500,344,27,589,2411
BOS,LAX,American Airlines Inc.,3664,885,2232,0,3620,10401
BOS,LAX,Delta Air Lines Inc.,944,39,753,31,702,2469
BOS,LAX,United Air Lines Inc.,1641,115,877,0,3144,5777
BOS,LGA,American Eagle Airlines Inc.,2553,250,14794,0,8651,26248
BOS,LGA,Delta Air Lines Inc.,1942,117,4612,0,2105,8776
BOS,LGA,US Airways Inc.,1602,1475,4558,69,3590,11294
BOS,LGB,JetBlue Airways,478,13,785,11,903,2190
BOS,MCO,Delta Air Lines Inc.,1526,146,1612,0,3473,6757
BOS,MCO,JetBlue Airways,2114,58,1846,0,6127,10145
BOS,MIA,American Airlines Inc.,6011,764,2644,0,7839,17258
BOS,MSY,JetBlue Airways,119,0,9,0,0,128
BOS,OAK,JetBlue Airways,516,0,199,0,355,1070
BOS,ORD,American Airlines Inc.,2812,827,16581,0,9685,29905
BOS,ORD,JetBlue Airways,111,0,14,0,0,125
BOS,ORD,United Air Lines Inc.,3043,441,13813,0,11818,29115
BOS,PBI,Delta Air Lines Inc.,1351,161,843,0,1406,3761
BOS,PBI,JetBlue Airways,969,0,397,0,778,2144
BOS,PDX,Alaska Airlines Inc.,583,29,356,0,1280,2248
BOS,PHL,US Airways Inc.,3336,2191,10177,30,7107,22841
BOS,PHX,US Airways Inc.,2019,110,797,11,1279,4216
BOS,PIT,JetBlue Airways,1222,0,493,0,2241,3956
BOS,PIT,US Airways Inc.,0,0,0,0,16,16
BOS,RDU,American Eagle Airlines Inc.,3001,864,2179,0,7600,13644
BOS,RDU,JetBlue Airways,353,0,94,0,462,909
BOS,RIC,JetBlue Airways,1065,0,492,0,4297,5854
BOS,RSW,Delta Air Lines Inc.,521,151,190,0,0,862
BOS,RSW,JetBlue Airways,1795,181,853,0,2646,5475
BOS,SAN,American Airlines Inc.,1551,158,585,0,568,2862
BOS,SAN,JetBlue Airways,440,0,756,0,354,1550
BOS,SEA,Alaska Airlines Inc.,374,20,341,0,791,1526
BOS,SEA,JetBlue Airways,250,0,60,0,441,751
BOS,SFO,American Airlines Inc.,1923,360,2365,0,1996,6644
BOS,SFO,JetBlue Airways,244,0,1308,0,68,1620
BOS,SFO,United Air Lines Inc.,3229,383,2597,0,4400,10609
BOS,SJC,JetBlue Airways,335,0,152,0,141,628
BOS,SJU,American Airlines Inc.,1670,550,634,0,1577,4431
BOS,SJU,JetBlue Airways,272,0,67,0,0,339
BOS,SJU,US Airways Inc.,487,56,406,47,113,1109
BOS,SLC,Delta Air Lines Inc.,666,20,483,0,1039,2208
BOS,SRQ,Delta Air Lines Inc.,26,56,88,0,0,170
BOS,STL,American Airlines Inc.,502,148,238,0,721,1609
BOS,STT,American Airlines Inc.,395,81,76,0,90,642
BOS,TPA,Delta Air Lines Inc.,1548,143,1305,0,2252,5248
BOS,TPA,JetBlue Airways,778,36,635,0,2283,3732
BQK,ATL,Atlantic Southeast Airlines,1742,655,965,0,389,3751
BQN,JFK,JetBlue Airways,243,0,148,0,784,1175
BQN,MCO,JetBlue Airways,176,0,13,0,1470,1659
BRW,ANC,Alaska Airlines Inc.,96,35,33,7,985,1156
BRW,FAI,Alaska Airlines Inc.,276,25,64,379,1025,1769
BTM,SLC,Skywest Airlines Inc.,41,434,0,0,401,876
BTR,ATL,Atlantic Southeast Airlines,12046,2309,4866,0,911,20132
BTR,DEN,Frontier Airlines Inc.,16,0,1,0,0,17
BTR,DFW,American Eagle Airlines Inc.,1646,4222,3906,0,12791,22565
BTR,ORD,American Eagle Airlines Inc.,568,575,1949,0,2299,5391
BTV,ATL,Atlantic Southeast Airlines,1305,391,558,15,74,2343
BTV,JFK,JetBlue Airways,562,352,4950,0,3084,8948
BTV,MCO,JetBlue Airways,797,0,49,0,256,1102
BTV,ORD,Skywest Airlines Inc.,228,170,2307,0,557,3262
BTV,ORD,United Air Lines Inc.,2850,10,1587,0,1797,6244
BUF,ATL,Atlantic Southeast Airlines,2191,1021,1252,0,552,5016
BUF,ATL,Delta Air Lines Inc.,1006,828,1230,0,811,3875
BUF,ATL,Skywest Airlines Inc.,1029,0,478,206,970,2683
BUF,BOS,JetBlue Airways,1290,94,1759,0,2381,5524
BUF,BWI,Southwest Airlines Co.,1649,2105,1632,124,9277,14787
BUF,CLT,US Airways Inc.,1103,887,760,48,1311,4109
BUF,DCA,US Airways Inc.,517,27,148,25,0,717
BUF,DFW,American Eagle Airlines Inc.,1233,0,74,0,0,1307
BUF,FLL,JetBlue Airways,997,0,269,0,349,1615
BUF,FLL,Southwest Airlines Co.,219,405,35,183,0,842
BUF,JFK,JetBlue Airways,2556,62,8499,0,5777,16894
BUF,LAS,Southwest Airlines Co.,289,66,309,0,1029,1693
BUF,MCO,JetBlue Airways,338,0,281,0,1291,1910
BUF,MCO,Southwest Airlines Co.,2153,1535,799,158,2623,7268
BUF,MDW,Southwest Airlines Co.,653,1211,745,133,2685,5427
BUF,ORD,American Eagle Airlines Inc.,485,932,5765,0,5658,12840
BUF,ORD,United Air Lines Inc.,2453,388,5067,0,5373,13281
BUF,PHL,US Airways Inc.,341,329,1548,0,176,2394
BUF,PHX,Southwest Airlines Co.,280,122,244,0,826,1472
BUF,RSW,JetBlue Airways,586,52,696,0,1721,3055
BUF,TPA,Southwest Airlines Co.,1137,886,482,284,786,3575
BUR,DEN,Skywest Airlines Inc.,953,106,69,0,713,1841
BUR,DEN,United Air Lines Inc.,515,0,90,0,0,605
BUR,DFW,American Airlines Inc.,2371,240,651,0,3631,6893
BUR,IAD,JetBlue Airways,0,0,0,0,25,25
BUR,JFK,JetBlue Airways,893,0,2231,0,2110,5234
BUR,LAS,JetBlue Airways,0,0,53,0,30,83
BUR,LAS,Southwest Airlines Co.,2278,779,3657,0,10330,17044
BUR,OAK,Southwest Airlines Co.,2149,299,1308,13,14870,18639
BUR,PDX,Alaska Airlines Inc.,364,0,2,0,45,411
BUR,PHX,Southwest Airlines Co.,1587,235,1139,14,7043,10018
BUR,PHX,US Airways Inc.,570,15,143,22,743,1493
BUR,SEA,Alaska Airlines Inc.,1567,61,507,0,2249,4384
BUR,SFO,Skywest Airlines Inc.,1449,33,7601,0,4703,13786
BUR,SFO,United Air Lines Inc.,751,0,6534,0,1351,8636
BUR,SJC,Southwest Airlines Co.,1508,269,778,4,9674,12233
BUR,SLC,JetBlue Airways,255,0,96,0,569,920
BUR,SLC,Skywest Airlines Inc.,2641,150,151,15,2571,5528
BUR,SMF,Southwest Airlines Co.,1583,188,595,0,10756,13122
BUR,TUS,Skywest Airlines Inc.,0,0,0,0,39,39
BWI,ABQ,Southwest Airlines Co.,880,345,547,0,600,2372
BWI,ALB,Southwest Airlines Co.,3331,1066,786,44,6209,11436
BWI,ATL,Delta Air Lines Inc.,3345,21,3151,0,4181,10698
BWI,AUS,Southwest Airlines Co.,853,235,380,6,1970,3444
BWI,BDL,Southwest Airlines Co.,4025,825,1752,151,8613,15366
BWI,BHM,Southwest Airlines Co.,1494,204,579,19,4066,6362
BWI,BNA,Southwest Airlines Co.,3301,582,1158,57,8765,13863
BWI,BUF,Southwest Airlines Co.,3008,1044,1425,46,9592,15115
BWI,CLE,Southwest Airlines Co.,2184,632,835,17,3274,6942
BWI,CLT,US Airways Inc.,3243,311,1857,7,2315,7733
BWI,CMH,Southwest Airlines Co.,2598,725,636,41,5566,9566
BWI,CVG,Atlantic Southeast Airlines,0,144,0,0,0,144
BWI,CVG,Delta Air Lines Inc.,192,0,56,0,0,248
BWI,DEN,Southwest Airlines Co.,3199,163,1180,40,3550,8132
BWI,DEN,United Air Lines Inc.,2448,298,1932,0,4541,9219
BWI,DFW,American Airlines Inc.,2197,266,2169,54,4394,9080
BWI,DTW,Southwest Airlines Co.,2052,691,1079,111,4862,8795
BWI,FLL,Southwest Airlines Co.,2105,130,1123,52,5365,8775
BWI,HOU,Southwest Airlines Co.,2223,379,1064,93,6723,10482
BWI,IND,Southwest Airlines Co.,1549,90,855,19,2430,4943
BWI,ISP,Southwest Airlines Co.,3237,950,838,123,5883,11031
BWI,JAN,Southwest Airlines Co.,1141,295,346,8,1693,3483
BWI,JAX,Southwest Airlines Co.,1459,26,601,30,4054,6170
BWI,JFK,American Eagle Airlines Inc.,277,164,1251,0,1735,3427
BWI,LAS,Southwest Airlines Co.,1881,407,1152,54,2003,5497
BWI,LAS,US Airways Inc.,741,276,604,0,2007,3628
BWI,LAX,United Air Lines Inc.,1943,60,1110,0,3359,6472
BWI,LIT,Southwest Airlines Co.,678,77,184,4,662,1605
BWI,MCI,Southwest Airlines Co.,1445,653,701,6,3085,5890
BWI,MCO,Southwest Airlines Co.,4048,372,2022,90,9474,16006
BWI,MCO,US Airways Inc.,111,0,82,0,0,193
BWI,MDW,Southwest Airlines Co.,3087,2217,2294,41,6960,14599
BWI,MHT,Southwest Airlines Co.,5495,798,1591,8,10749,18641
BWI,MIA,American Airlines Inc.,1342,56,520,8,936,2862
BWI,MKE,Skywest Airlines Inc.,3096,1520,1218,0,925,6759
BWI,MSY,Southwest Airlines Co.,493,163,404,13,1021,2094
BWI,OKC,Southwest Airlines Co.,802,417,120,15,2335,3689
BWI,ORD,American Eagle Airlines Inc.,2566,1769,5343,0,6978,16656
BWI,ORD,United Air Lines Inc.,3072,302,7730,0,7747,18851
BWI,ORF,Southwest Airlines Co.,3643,341,534,12,5170,9700
BWI,PBI,Southwest Airlines Co.,1937,151,618,83,4452,7241
BWI,PHL,US Airways Inc.,331,105,1071,0,1032,2539
BWI,PHX,Southwest Airlines Co.,1631,337,1720,31,2777,6496
BWI,PHX,US Airways Inc.,1358,388,413,7,650,2816
BWI,PIT,Southwest Airlines Co.,1090,449,484,0,3329,5352
BWI,PVD,Southwest Airlines Co.,4869,908,1891,44,12008,19720
BWI,RDU,Southwest Airlines Co.,3327,395,1046,78,8970,13816
BWI,RSW,Southwest Airlines Co.,974,42,597,7,2642,4262
BWI,SAN,Southwest Airlines Co.,1304,296,1194,15,1929,4738
BWI,SAT,Southwest Airlines Co.,950,206,528,9,1413,3106
BWI,SDF,Southwest Airlines Co.,2410,520,639,23,3883,7475
BWI,SFO,United Air Lines Inc.,449,72,469,0,341,1331
BWI,SJU,American Airlines Inc.,285,14,33,0,0,332
BWI,SLC,Delta Air Lines Inc.,223,28,157,0,433,841
BWI,SLC,Southwest Airlines Co.,337,0,293,32,206,868
BWI,STL,Southwest Airlines Co.,3315,803,1149,50,3808,9125
BWI,TPA,Southwest Airlines Co.,2192,237,1336,20,7592,11377
BZN,ATL,Delta Air Lines Inc.,208,0,24,0,48,280
BZN,DEN,Skywest Airlines Inc.,2507,726,453,0,3779,7465
BZN,DEN,United Air Lines Inc.,468,71,273,0,480,1292
BZN,ORD,Skywest Airlines Inc.,1089,0,5705,0,820,7614
BZN,ORD,United Air Lines Inc.,62,0,677,0,346,1085
BZN,SFO,Skywest Airlines Inc.,18,0,518,0,39,575
BZN,SLC,Skywest Airlines Inc.,1074,1389,285,0,3926,6674
CAE,ATL,Atlantic Southeast Airlines,5116,2035,3167,8,782,11108
CAE,ATL,Delta Air Lines Inc.,1530,0,1064,0,367,2961
CAE,CVG,Atlantic Southeast Airlines,1082,260,234,0,122,1698
CAE,DFW,American Eagle Airlines Inc.,2187,182,669,0,2970,6008
CAE,LGA,Atlantic Southeast Airlines,1185,232,6741,0,138,8296
CAK,ATL,Atlantic Southeast Airlines,7499,3742,3348,72,3160,17821
CAK,CVG,Atlantic Southeast Airlines,0,16,0,0,0,16
CAK,DEN,Frontier Airlines Inc.,1131,71,662,0,985,2849
CAK,ORD,Skywest Airlines Inc.,149,0,3420,0,1254,4823
CDC,LAX,Skywest Airlines Inc.,26,0,0,0,0,26
CDC,SLC,Skywest Airlines Inc.,574,29,20,0,1373,1996
CDV,ANC,Alaska Airlines Inc.,38,1,107,28,1932,2106
CDV,YAK,Alaska Airlines Inc.,510,34,57,0,1911,2512
CEC,ACV,Skywest Airlines Inc.,1862,64,571,0,2393,4890
CEC,SFO,Skywest Airlines Inc.,939,144,7879,0,1382,10344
CHA,ATL,Atlantic Southeast Airlines,6199,1230,3791,0,519,11739
CHA,DFW,American Eagle Airlines Inc.,1037,25,540,0,1405,3007
CHA,ORD,American Eagle Airlines Inc.,647,115,2847,0,2708,6317
CHO,ATL,Atlantic Southeast Airlines,1371,756,1997,0,379,4503
CHO,CVG,Atlantic Southeast Airlines,21,0,6,0,0,27
CHS,ATL,Atlantic Southeast Airlines,2609,627,1398,0,1889,6523
CHS,ATL,Delta Air Lines Inc.,4836,220,2586,0,2232,9874
CHS,CLT,US Airways Inc.,108,230,233,0,614,1185
CHS,DFW,American Eagle Airlines Inc.,3199,120,1735,0,3760,8814
CHS,ORD,Skywest Airlines Inc.,550,306,2458,0,647,3961
CIC,SFO,Skywest Airlines Inc.,1706,61,6909,55,5041,13772
CID,ATL,Atlantic Southeast Airlines,2151,651,551,0,303,3656
CID,CVG,Atlantic Southeast Airlines,0,44,9,0,0,53
CID,DEN,Skywest Airlines Inc.,1033,692,1026,0,4161,6912
CID,DFW,American Eagle Airlines Inc.,2671,1070,1532,0,4073,9346
CID,MKE,Skywest Airlines Inc.,0,0,107,0,0,107
CID,ORD,American Eagle Airlines Inc.,2250,2024,8331,0,6065,18670
CID,ORD,Skywest Airlines Inc.,551,37,8877,56,1438,10959
CLD,LAX,Skywest Airlines Inc.,1925,65,1993,0,2577,6560
CLE,ATL,Atlantic Southeast Airlines,5835,1836,3650,0,1480,12801
CLE,ATL,Delta Air Lines Inc.,1500,78,516,40,192,2326
CLE,ATL,Skywest Airlines Inc.,64,0,105,0,0,169
CLE,BNA,Southwest Airlines Co.,1127,793,506,0,2457,4883
CLE,BWI,Southwest Airlines Co.,916,923,1028,8,4814,7689
CLE,CLT,US Airways Inc.,674,235,315,0,378,1602
CLE,CVG,Atlantic Southeast Airlines,31,0,0,0,0,31
CLE,DEN,Skywest Airlines Inc.,161,230,0,0,1358,1749
CLE,DEN,United Air Lines Inc.,1401,94,142,0,134,1771
CLE,DFW,American Eagle Airlines Inc.,4875,771,1281,0,5027,11954
CLE,JFK,American Eagle Airlines Inc.,365,7,821,0,1267,2460
CLE,LAS,Southwest Airlines Co.,311,8,621,0,370,1310
CLE,LGA,American Eagle Airlines Inc.,2662,204,7013,0,7003,16882
CLE,MCO,Southwest Airlines Co.,783,28,333,0,687,1831
CLE,MDW,Southwest Airlines Co.,1509,2217,3011,20,6972,13729
CLE,MIA,American Eagle Airlines Inc.,85,17,79,0,414,595
CLE,MKE,Skywest Airlines Inc.,913,181,285,0,201,1580
CLE,ORD,American Eagle Airlines Inc.,3231,182,9795,0,7268,20476
CLE,ORD,Skywest Airlines Inc.,453,691,7231,0,1529,9904
CLE,ORD,United Air Lines Inc.,3344,165,8318,0,5129,16956
CLE,PHX,US Airways Inc.,1013,18,92,0,189,1312
CLE,SLC,Delta Air Lines Inc.,305,2,281,0,194,782
CLE,SLC,Skywest Airlines Inc.,124,0,22,0,732,878
CLE,STL,Southwest Airlines Co.,669,114,348,0,1491,2622
CLL,DFW,American Eagle Airlines Inc.,2342,966,1233,0,2780,7321
CLT,ABE,US Airways Inc.,270,123,144,43,531,1111
CLT,ALB,US Airways Inc.,895,141,411,39,1230,2716
CLT,ATL,Atlantic Southeast Airlines,1455,1074,2064,0,1229,5822
CLT,ATL,Delta Air Lines Inc.,4021,496,2428,0,3788,10733
CLT,ATL,US Airways Inc.,493,0,1829,59,1228,3609
CLT,BDL,US Airways Inc.,1455,102,861,22,3390,5830
CLT,BNA,US Airways Inc.,1447,84,439,15,2636,4621
CLT,BOS,JetBlue Airways,825,0,466,0,379,1670
CLT,BOS,US Airways Inc.,3672,229,6154,12,6685,16752
CLT,BUF,US Airways Inc.,1771,156,215,17,3112,5271
CLT,BWI,US Airways Inc.,2298,170,3030,81,5640,11219
CLT,CHS,US Airways Inc.,428,0,243,0,1205,1876
CLT,CLE,US Airways Inc.,911,11,160,0,1031,2113
CLT,CVG,Atlantic Southeast Airlines,205,41,0,0,0,246
CLT,DAB,US Airways Inc.,0,0,0,0,65,65
CLT,DCA,US Airways Inc.,2781,191,2331,6,4819,10128
CLT,DEN,US Airways Inc.,1751,61,1063,100,1978,4953
CLT,DEN,United Air Lines Inc.,1530,33,747,0,2626,4936
CLT,DFW,American Airlines Inc.,3773,390,1463,0,2888,8514
CLT,DFW,US Airways Inc.,2215,144,1565,11,3319,7254
CLT,DTW,US Airways Inc.,405,84,63,0,374,926
CLT,EGE,US Airways Inc.,26,0,0,0,41,67
CLT,EWR,US Airways Inc.,1298,250,21369,0,3995,26912
CLT,FLL,JetBlue Airways,181,0,225,0,641,1047
CLT,FLL,US Airways Inc.,4620,226,1848,54,6889,13637
CLT,IAD,US Airways Inc.,1492,148,394,9,1542,3585
CLT,IAH,US Airways Inc.,1200,36,820,0,1460,3516
CLT,ILM,US Airways Inc.,417,80,282,0,907,1686
CLT,IND,US Airways Inc.,1030,0,279,44,1659,3012
CLT,JAX,US Airways Inc.,2302,159,923,151,4017,7552
CLT,JFK,JetBlue Airways,798,20,4956,0,4538,10312
CLT,LAS,US Airways Inc.,3567,180,1854,34,3182,8817
CLT,LAX,US Airways Inc.,2645,255,2141,192,2340,7573
CLT,LGA,American Eagle Airlines Inc.,2283,321,9589,0,7853,20046
CLT,LGA,US Airways Inc.,2387,192,13461,77,6733,22850
CLT,MCI,US Airways Inc.,774,0,233,0,595,1602
CLT,MCO,US Airways Inc.,4685,139,2543,231,7799,15397
CLT,MDT,US Airways Inc.,378,191,214,0,1441,2224
CLT,MHT,US Airways Inc.,441,48,114,0,1271,1874
CLT,MIA,American Eagle Airlines Inc.,2226,719,1268,0,7479,11692
CLT,MIA,US Airways Inc.,2782,144,1344,53,3032,7355
CLT,MKE,Skywest Airlines Inc.,1558,418,162,0,0,2138
CLT,MSP,US Airways Inc.,685,152,319,12,1122,2290
CLT,MSY,US Airways Inc.,1391,0,551,0,1742,3684
CLT,MYR,US Airways Inc.,1483,31,616,0,2588,4718
CLT,ORD,American Eagle Airlines Inc.,2234,775,8813,0,8709,20531
CLT,ORD,US Airways Inc.,2167,149,11375,0,4652,18343
CLT,ORD,United Air Lines Inc.,887,214,8723,0,6676,16500
CLT,ORF,US Airways Inc.,683,24,211,51,1230,2199
CLT,PBI,US Airways Inc.,2311,35,930,33,3300,6609
CLT,PDX,US Airways Inc.,147,14,204,0,371,736
CLT,PHL,US Airways Inc.,3442,216,8583,24,5459,17724
CLT,PHX,US Airways Inc.,3436,207,2192,27,4652,10514
CLT,PIT,US Airways Inc.,2517,153,763,0,4525,7958
CLT,PVD,US Airways Inc.,1285,125,844,0,2108,4362
CLT,RDU,US Airways Inc.,2912,63,830,0,4027,7832
CLT,RIC,US Airways Inc.,866,169,281,20,1841,3177
CLT,ROC,US Airways Inc.,357,10,137,16,751,1271
CLT,RSW,US Airways Inc.,3012,195,857,16,3242,7322
CLT,SAN,US Airways Inc.,1159,118,332,0,567,2176
CLT,SAV,US Airways Inc.,402,80,79,15,598,1174
CLT,SDF,US Airways Inc.,11,0,4,0,0,15
CLT,SEA,US Airways Inc.,1024,7,718,65,589,2403
CLT,SFO,US Airways Inc.,2268,79,4931,30,2517,9825
CLT,SJU,US Airways Inc.,1418,0,307,0,1222,2947
CLT,SLC,Delta Air Lines Inc.,421,0,135,0,0,556
CLT,SMF,US Airways Inc.,122,7,204,0,176,509
CLT,STL,US Airways Inc.,544,44,222,0,408,1218
CLT,STT,US Airways Inc.,515,0,186,0,1054,1755
CLT,STX,US Airways Inc.,50,0,15,0,53,118
CLT,SYR,US Airways Inc.,779,149,145,0,1473,2546
CLT,TPA,US Airways Inc.,3211,219,1703,68,6918,12119
CLT,TUS,US Airways Inc.,37,28,104,0,158,327
CMH,ATL,Atlantic Southeast Airlines,620,203,42,0,234,1099
CMH,ATL,Delta Air Lines Inc.,1270,254,778,0,444,2746
CMH,ATL,Skywest Airlines Inc.,256,234,449,0,538,1477
CMH,BNA,Southwest Airlines Co.,639,206,260,0,1995,3100
CMH,BOS,American Eagle Airlines Inc.,1364,63,613,0,852,2892
CMH,BOS,JetBlue Airways,7,0,5,0,26,38
CMH,BWI,Southwest Airlines Co.,955,392,1628,0,3500,6475
CMH,CVG,Delta Air Lines Inc.,652,36,296,0,0,984
CMH,DEN,United Air Lines Inc.,497,43,288,0,1213,2041
CMH,DFW,American Airlines Inc.,406,218,633,0,3347,4604
CMH,DFW,American Eagle Airlines Inc.,1482,105,414,0,714,2715
CMH,JFK,JetBlue Airways,8,0,37,0,69,114
CMH,LAS,Southwest Airlines Co.,798,161,780,6,2295,4040
CMH,LAS,US Airways Inc.,487,255,291,0,674,1707
CMH,LAX,Delta Air Lines Inc.,157,4,36,0,89,286
CMH,LGA,American Eagle Airlines Inc.,5365,1087,6687,0,5351,18490
CMH,MCI,Skywest Airlines Inc.,1948,436,0,0,32,2416
CMH,MCO,Southwest Airlines Co.,1592,320,628,0,3005,5545
CMH,MDW,Southwest Airlines Co.,2343,1413,3323,0,9455,16534
CMH,MIA,American Eagle Airlines Inc.,2411,301,257,0,0,2969
CMH,MKE,Skywest Airlines Inc.,3336,1449,1087,12,470,6354
CMH,ORD,American Eagle Airlines Inc.,7155,1084,13423,0,14291,35953
CMH,ORD,Skywest Airlines Inc.,116,0,713,0,0,829
CMH,ORD,United Air Lines Inc.,1310,167,7564,0,5798,14839
CMH,PHL,Southwest Airlines Co.,696,974,2499,0,2534,6703
CMH,PHX,Southwest Airlines Co.,667,0,998,0,1019,2684
CMH,PHX,US Airways Inc.,965,323,232,0,232,1752
CMH,RDU,American Eagle Airlines Inc.,2030,0,358,0,0,2388
CMH,SLC,Skywest Airlines Inc.,523,46,288,0,803,1660
CMH,STL,Southwest Airlines Co.,396,50,299,0,1024,1769
CMH,TPA,Southwest Airlines Co.,1206,185,394,0,2620,4405
CMI,DFW,American Eagle Airlines Inc.,1366,67,240,0,361,2034
CMI,ORD,American Eagle Airlines Inc.,8608,383,10039,0,6892,25922
COD,DEN,Skywest Airlines Inc.,89,0,76,0,0,165
COD,SLC,Skywest Airlines Inc.,101,33,75,0,1282,1491
COS,ATL,Delta Air Lines Inc.,172,200,132,0,416,920
COS,ATL,Skywest Airlines Inc.,1095,395,144,46,50,1730
COS,CLE,Skywest Airlines Inc.,0,90,0,0,0,90
COS,DEN,Skywest Airlines Inc.,6660,651,1339,44,4488,13182
COS,DFW,American Airlines Inc.,2763,666,1365,31,4712,9537
COS,LAX,Skywest Airlines Inc.,2592,502,100,157,1607,4958
COS,MCI,Skywest Airlines Inc.,1378,120,26,0,0,1524
COS,ORD,Skywest Airlines Inc.,3422,651,7234,20,716,12043
COS,SFO,Skywest Airlines Inc.,290,0,40,120,0,450
COS,SLC,Skywest Airlines Inc.,1388,162,116,0,1260,2926
CPR,DEN,Skywest Airlines Inc.,231,114,77,0,349,771
CPR,ORD,Skywest Airlines Inc.,38,0,580,0,0,618
CPR,SLC,Skywest Airlines Inc.,1068,190,0,0,782,2040
CRP,ATL,Atlantic Southeast Airlines,0,0,5,0,40,45
CRP,DFW,American Eagle Airlines Inc.,1513,1595,1127,0,7300,11535
CRP,HOU,Southwest Airlines Co.,521,384,1494,0,7834,10233
CRW,ATL,Atlantic Southeast Airlines,4270,1016,2444,0,484,8214
CRW,ORD,Skywest Airlines Inc.,939,80,4902,15,2160,8096
CSG,ATL,Atlantic Southeast Airlines,4671,1601,1466,12,548,8298
CVG,ABE,Atlantic Southeast Airlines,118,62,24,0,0,204
CVG,ABQ,Delta Air Lines Inc.,641,94,172,0,73,980
CVG,ALB,Atlantic Southeast Airlines,0,178,201,0,0,379
CVG,ANC,Delta Air Lines Inc.,132,22,204,0,216,574
CVG,ATL,Atlantic Southeast Airlines,2401,467,991,0,211,4070
CVG,ATL,Delta Air Lines Inc.,1995,67,1865,0,1141,5068
CVG,ATL,Skywest Airlines Inc.,12,28,298,0,789,1127
CVG,AVL,Atlantic Southeast Airlines,9,0,18,0,0,27
CVG,AVP,Atlantic Southeast Airlines,0,224,149,0,0,373
CVG,AZO,Atlantic Southeast Airlines,54,54,0,0,0,108
CVG,BDL,Delta Air Lines Inc.,656,206,517,0,1022,2401
CVG,BHM,Atlantic Southeast Airlines,37,30,0,0,0,67
CVG,BNA,Atlantic Southeast Airlines,278,0,176,0,0,454
CVG,BOS,Atlantic Southeast Airlines,40,0,11,0,0,51
CVG,BOS,Delta Air Lines Inc.,736,378,1129,0,840,3083
CVG,BTR,Atlantic Southeast Airlines,30,0,39,0,0,69
CVG,BWI,Atlantic Southeast Airlines,100,196,1,0,0,297
CVG,BWI,Delta Air Lines Inc.,149,26,140,0,740,1055
CVG,CAE,Atlantic Southeast Airlines,2226,655,660,0,88,3629
CVG,CAK,Atlantic Southeast Airlines,13,0,10,0,0,23
CVG,CHO,Atlantic Southeast Airlines,288,32,0,0,0,320
CVG,CID,Atlantic Southeast Airlines,59,32,2,0,0,93
CVG,CLE,Atlantic Southeast Airlines,95,0,0,0,0,95
CVG,CLT,Atlantic Southeast Airlines,218,44,30,0,0,292
CVG,CMH,Delta Air Lines Inc.,496,127,238,0,1378,2239
CVG,DCA,Delta Air Lines Inc.,641,76,681,0,882,2280
CVG,DEN,Delta Air Lines Inc.,600,60,311,0,1031,2002
CVG,DEN,Skywest Airlines Inc.,728,83,105,0,2211,3127
CVG,DFW,American Eagle Airlines Inc.,2739,170,2952,7,6149,12017
CVG,DFW,Atlantic Southeast Airlines,17,0,0,0,0,17
CVG,DFW,Skywest Airlines Inc.,165,124,252,0,1165,1706
CVG,DTW,Atlantic Southeast Airlines,0,10,13,0,0,23
CVG,EGE,Delta Air Lines Inc.,77,13,25,0,18,133
CVG,EVV,Atlantic Southeast Airlines,115,37,0,0,0,152
CVG,EWR,Atlantic Southeast Airlines,1243,141,6467,0,0,7851
CVG,FLL,Delta Air Lines Inc.,801,10,419,0,535,1765
CVG,GRB,Atlantic Southeast Airlines,506,405,178,0,51,1140
CVG,GRR,Atlantic Southeast Airlines,40,11,148,0,0,199
CVG,GSP,Atlantic Southeast Airlines,25,0,0,0,0,25
CVG,HSV,Atlantic Southeast Airlines,376,55,224,0,0,655
CVG,IAD,Atlantic Southeast Airlines,365,0,25,0,0,390
CVG,IAH,Atlantic Southeast Airlines,22,0,0,0,0,22
CVG,JAC,Delta Air Lines Inc.,73,88,33,0,0,194
CVG,JAN,Atlantic Southeast Airlines,213,20,24,0,57,314
CVG,JAX,Atlantic Southeast Airlines,14,0,10,0,0,24
CVG,JFK,Delta Air Lines Inc.,519,6,1981,0,290,2796
CVG,LAS,Delta Air Lines Inc.,2154,385,899,0,1433,4871
CVG,LAX,Delta Air Lines Inc.,1181,177,808,0,765,2931
CVG,LEX,Atlantic Southeast Airlines,73,0,2,0,0,75
CVG,LGA,American Eagle Airlines Inc.,2783,64,7587,0,7315,17749
CVG,LGA,Delta Air Lines Inc.,794,65,3150,0,1525,5534
CVG,LIT,Atlantic Southeast Airlines,85,0,0,0,0,85
CVG,MCI,Atlantic Southeast Airlines,23,0,3,0,0,26
CVG,MCO,Delta Air Lines Inc.,1032,239,1041,0,1159,3471
CVG,MDT,Atlantic Southeast Airlines,421,253,345,0,0,1019
CVG,MEM,Atlantic Southeast Airlines,1466,507,247,0,13,2233
CVG,MHT,Atlantic Southeast Airlines,0,0,40,0,0,40
CVG,MIA,American Eagle Airlines Inc.,467,37,401,0,441,1346
CVG,MKE,Atlantic Southeast Airlines,0,42,0,0,0,42
CVG,OMA,Atlantic Southeast Airlines,14,45,39,0,211,309
CVG,ORD,American Eagle Airlines Inc.,4501,650,10915,0,11099,27165
CVG,ORD,Delta Air Lines Inc.,69,0,338,0,41,448
CVG,ORD,Skywest Airlines Inc.,1063,1270,7010,0,2419,11762
CVG,ORD,United Air Lines Inc.,1232,347,3124,0,1237,5940
CVG,ORF,Atlantic Southeast Airlines,0,74,0,0,0,74
CVG,PDX,Delta Air Lines Inc.,270,67,144,0,180,661
CVG,PHL,Atlantic Southeast Airlines,606,93,198,0,0,897
CVG,PHL,Skywest Airlines Inc.,38,0,123,0,0,161
CVG,PHX,Delta Air Lines Inc.,384,137,514,0,702,1737
CVG,PIT,Atlantic Southeast Airlines,178,21,101,0,29,329
CVG,PIT,Delta Air Lines Inc.,508,206,172,0,741,1627
CVG,PVD,Atlantic Southeast Airlines,0,146,855,0,0,1001
CVG,ROC,Atlantic Southeast Airlines,0,174,0,0,0,174
CVG,RSW,Delta Air Lines Inc.,573,69,317,0,294,1253
CVG,SAN,Delta Air Lines Inc.,813,314,447,0,686,2260
CVG,SAT,Atlantic Southeast Airlines,0,80,4,0,0,84
CVG,SDF,Atlantic Southeast Airlines,363,338,82,0,0,783
CVG,SEA,Delta Air Lines Inc.,783,89,349,30,681,1932
CVG,SFO,Delta Air Lines Inc.,1242,206,1022,0,725,3195
CVG,SGF,Atlantic Southeast Airlines,318,158,168,0,0,644
CVG,SLC,Delta Air Lines Inc.,2697,324,1271,0,1796,6088
CVG,SLC,Skywest Airlines Inc.,185,0,66,0,0,251
CVG,SNA,Delta Air Lines Inc.,584,33,171,0,137,925
CVG,SYR,Atlantic Southeast Airlines,110,0,46,0,0,156
CVG,TPA,Delta Air Lines Inc.,1491,184,776,0,1243,3694
CVG,TRI,Atlantic Southeast Airlines,392,17,6,0,0,415
CVG,TUL,Atlantic Southeast Airlines,453,171,27,0,0,651
CVG,TYS,Atlantic Southeast Airlines,0,0,34,0,0,34
CVG,XNA,Atlantic Southeast Airlines,45,44,0,0,0,89
CWA,MKE,Skywest Airlines Inc.,129,177,18,0,80,404
CWA,ORD,American Eagle Airlines Inc.,93,176,791,0,421,1481
CWA,ORD,Skywest Airlines Inc.,418,91,3244,0,828,4581
DAB,ATL,Atlantic Southeast Airlines,1470,414,1063,0,742,3689
DAB,ATL,Delta Air Lines Inc.,2450,70,1668,0,1472,5660
DAL,ABQ,Southwest Airlines Co.,3593,300,1123,83,11772,16871
DAL,AMA,Southwest Airlines Co.,3355,1258,970,0,8765,14348
DAL,AUS,American Eagle Airlines Inc.,1972,402,1505,0,7433,11312
DAL,AUS,Southwest Airlines Co.,5452,625,2400,0,13465,21942
DAL,BHM,Southwest Airlines Co.,969,328,330,0,2127,3754
DAL,ELP,Southwest Airlines Co.,2327,233,879,24,8961,12424
DAL,HOU,Southwest Airlines Co.,10869,4699,11944,53,36569,64134
DAL,HRL,Southwest Airlines Co.,19,0,1,0,52,72
DAL,LBB,Southwest Airlines Co.,3619,432,1218,0,11299,16568
DAL,LIT,Southwest Airlines Co.,3066,926,1168,36,11051,16247
DAL,MAF,Southwest Airlines Co.,2155,278,1058,4,13286,16781
DAL,MCI,American Eagle Airlines Inc.,3960,712,1448,0,8069,14189
DAL,MCI,Southwest Airlines Co.,3594,423,1556,20,10857,16450
DAL,MSY,Southwest Airlines Co.,3672,360,1508,13,7766,13319
DAL,OKC,Southwest Airlines Co.,3154,428,710,16,7485,11793
DAL,SAT,Southwest Airlines Co.,7838,406,3206,20,14513,25983
DAL,STL,Southwest Airlines Co.,3885,426,1054,34,7824,13223
DAL,TUL,Southwest Airlines Co.,3006,399,1281,0,6443,11129
DAY,ATL,Atlantic Southeast Airlines,3222,1443,1605,0,1099,7369
DAY,ATL,Delta Air Lines Inc.,1832,20,1443,0,1611,4906
DAY,DEN,Frontier Airlines Inc.,1092,52,623,0,646,2413
DAY,DEN,Skywest Airlines Inc.,190,0,4,0,474,668
DAY,DFW,American Airlines Inc.,1875,149,1100,0,1866,4990
DAY,MKE,Skywest Airlines Inc.,1509,535,150,0,323,2517
DAY,ORD,American Eagle Airlines Inc.,1776,47,2901,0,2885,7609
DAY,ORD,Skywest Airlines Inc.,822,0,3692,0,1791,6305
DAY,ORD,United Air Lines Inc.,3327,18,1936,0,886,6167
DBQ,ORD,American Eagle Airlines Inc.,781,274,3975,0,4649,9679
DCA,ALB,US Airways Inc.,320,60,101,0,785,1266
DCA,ATL,Atlantic Southeast Airlines,103,0,0,0,0,103
DCA,ATL,Delta Air Lines Inc.,4731,473,6222,0,5084,16510
DCA,BDL,US Airways Inc.,554,258,590,63,1857,3322
DCA,BNA,American Eagle Airlines Inc.,1449,50,991,0,5337,7827
DCA,BOS,American Eagle Airlines Inc.,3826,656,3567,0,6903,14952
DCA,BOS,Atlantic Southeast Airlines,193,0,58,0,0,251
DCA,BOS,US Airways Inc.,1333,1202,2399,0,4348,9282
DCA,BUF,US Airways Inc.,429,339,168,0,610,1546
DCA,CLT,US Airways Inc.,1838,1157,2091,0,2548,7634
DCA,CVG,Delta Air Lines Inc.,598,24,216,0,648,1486
DCA,DEN,Frontier Airlines Inc.,978,162,872,0,567,2579
DCA,DEN,United Air Lines Inc.,984,135,609,0,2063,3791
DCA,DFW,American Airlines Inc.,5034,1192,5849,0,10629,22704
DCA,FLL,US Airways Inc.,1819,334,1256,9,2308,5726
DCA,HSV,Atlantic Southeast Airlines,127,0,0,0,0,127
DCA,IND,US Airways Inc.,0,212,0,0,87,299
DCA,JAN,Atlantic Southeast Airlines,89,57,31,0,43,220
DCA,JAX,US Airways Inc.,625,96,370,0,1330,2421
DCA,JFK,American Eagle Airlines Inc.,1293,70,4439,0,3459,9261
DCA,LAS,US Airways Inc.,1167,137,426,81,2172,3983
DCA,LAX,Alaska Airlines Inc.,874,20,143,0,0,1037
DCA,LGA,American Eagle Airlines Inc.,2588,23,9689,0,7107,19407
DCA,LGA,Delta Air Lines Inc.,1310,95,3463,0,969,5837
DCA,LGA,US Airways Inc.,1497,714,4903,0,5193,12307
DCA,MCO,US Airways Inc.,1448,438,1541,0,2914,6341
DCA,MHT,US Airways Inc.,210,48,112,0,544,914
DCA,MIA,American Airlines Inc.,4443,512,3701,0,10131,18787
DCA,MSY,US Airways Inc.,195,254,257,0,441,1147
DCA,ORD,American Airlines Inc.,2160,56,8492,0,5140,15848
DCA,ORD,American Eagle Airlines Inc.,349,15,1349,0,2669,4382
DCA,ORD,United Air Lines Inc.,4571,926,14405,0,12615,32517
DCA,PBI,US Airways Inc.,888,126,791,21,854,2680
DCA,PHX,US Airways Inc.,1595,329,967,4,730,3625
DCA,PIT,US Airways Inc.,91,113,107,0,225,536
DCA,PVD,US Airways Inc.,521,246,415,0,1245,2427
DCA,RDU,American Eagle Airlines Inc.,3572,550,1556,0,7870,13548
DCA,RSW,US Airways Inc.,439,0,121,0,326,886
DCA,SEA,Alaska Airlines Inc.,550,28,575,0,486,1639
DCA,SLC,Delta Air Lines Inc.,110,0,96,0,618,824
DCA,SRQ,US Airways Inc.,31,0,6,0,0,37
DCA,STL,American Airlines Inc.,1250,251,678,0,2742,4921
DCA,SYR,US Airways Inc.,197,110,25,0,560,892
DCA,TPA,US Airways Inc.,1755,599,1369,0,2228,5951
DCA,XNA,American Eagle Airlines Inc.,577,198,698,0,1712,3185
DEN,ABQ,Frontier Airlines Inc.,744,35,1036,0,668,2483
DEN,ABQ,Skywest Airlines Inc.,514,2,187,0,2236,2939
DEN,ABQ,Southwest Airlines Co.,1406,0,235,1,4297,5939
DEN,ABQ,United Air Lines Inc.,2516,134,752,0,5382,8784
DEN,AMA,Southwest Airlines Co.,822,181,132,9,980,2124
DEN,ANC,Frontier Airlines Inc.,214,0,371,0,110,695
DEN,ANC,United Air Lines Inc.,737,54,305,0,1137,2233
DEN,ASE,Skywest Airlines Inc.,3514,2474,431,35,11313,17767
DEN,ATL,Delta Air Lines Inc.,3455,153,2012,0,3142,8762
DEN,ATL,Frontier Airlines Inc.,3035,63,2665,0,516,6279
DEN,ATL,United Air Lines Inc.,828,40,463,0,876,2207
DEN,AUS,Frontier Airlines Inc.,1216,48,1851,0,1070,4185
DEN,AUS,Skywest Airlines Inc.,338,0,30,0,1037,1405
DEN,AUS,Southwest Airlines Co.,253,45,96,0,577,971
DEN,AUS,United Air Lines Inc.,2347,42,410,0,3249,6048
DEN,BDL,Frontier Airlines Inc.,480,0,202,0,21,703
DEN,BFL,Skywest Airlines Inc.,349,0,60,0,1130,1539
DEN,BHM,Skywest Airlines Inc.,702,42,290,0,2195,3229
DEN,BIL,Skywest Airlines Inc.,294,38,50,0,419,801
DEN,BIL,United Air Lines Inc.,2641,39,419,0,5248,8347
DEN,BIS,Skywest Airlines Inc.,1347,108,322,0,3233,5010
DEN,BNA,Frontier Airlines Inc.,1462,35,2212,0,728,4437
DEN,BNA,Skywest Airlines Inc.,952,0,144,1,1140,2237
DEN,BNA,Southwest Airlines Co.,925,12,329,5,1783,3054
DEN,BOI,Frontier Airlines Inc.,429,0,350,0,274,1053
DEN,BOI,Skywest Airlines Inc.,726,53,187,0,1101,2067
DEN,BOI,United Air Lines Inc.,2729,125,673,0,6069,9596
DEN,BOS,JetBlue Airways,182,0,175,0,2445,2802
DEN,BOS,United Air Lines Inc.,4124,252,4023,0,7681,16080
DEN,BUR,Skywest Airlines Inc.,1522,97,140,0,2771,4530
DEN,BUR,United Air Lines Inc.,1105,46,255,0,1398,2804
DEN,BWI,Southwest Airlines Co.,1555,37,815,0,1203,3610
DEN,BWI,United Air Lines Inc.,3836,149,2013,0,7643,13641
DEN,BZN,Skywest Airlines Inc.,1218,85,313,0,4155,5771
DEN,BZN,United Air Lines Inc.,625,0,180,0,862,1667
DEN,CAK,Frontier Airlines Inc.,1134,9,1029,0,1085,3257
DEN,CID,Skywest Airlines Inc.,577,76,265,0,1909,2827
DEN,CLE,Skywest Airlines Inc.,218,0,0,0,193,411
DEN,CLE,United Air Lines Inc.,580,22,76,0,1187,1865
DEN,CLT,US Airways Inc.,2335,0,281,0,639,3255
DEN,CLT,United Air Lines Inc.,1665,96,367,0,1957,4085
DEN,CMH,United Air Lines Inc.,1624,207,278,0,1653,3762
DEN,COD,Skywest Airlines Inc.,115,0,26,0,216,357
DEN,COS,Skywest Airlines Inc.,3565,581,1099,0,11709,16954
DEN,CPR,Skywest Airlines Inc.,175,108,55,0,701,1039
DEN,CVG,Delta Air Lines Inc.,261,23,44,0,354,682
DEN,CVG,Skywest Airlines Inc.,382,97,245,0,1625,2349
DEN,DAY,Frontier Airlines Inc.,1236,0,903,0,413,2552
DEN,DAY,Skywest Airlines Inc.,273,0,91,0,606,970
DEN,DCA,Frontier Airlines Inc.,1737,77,1328,0,879,4021
DEN,DCA,United Air Lines Inc.,1021,220,452,0,1344,3037
DEN,DFW,American Airlines Inc.,4808,383,5835,15,13705,24746
DEN,DFW,Frontier Airlines Inc.,2682,90,2757,0,1444,6973
DEN,DFW,Skywest Airlines Inc.,0,0,0,0,16,16
DEN,DFW,United Air Lines Inc.,5764,282,2624,0,9558,18228
DEN,DRO,Skywest Airlines Inc.,1144,120,444,0,1833,3541
DEN,DSM,Skywest Airlines Inc.,129,67,189,0,705,1090
DEN,DSM,United Air Lines Inc.,2306,25,794,0,5050,8175
DEN,DTW,Frontier Airlines Inc.,1513,66,2245,0,988,4812
DEN,DTW,United Air Lines Inc.,1226,43,335,0,2577,4181
DEN,EGE,United Air Lines Inc.,1527,618,400,0,1309,3854
DEN,ELP,Skywest Airlines Inc.,1160,125,248,0,2227,3760
DEN,EUG,Skywest Airlines Inc.,535,31,146,0,2741,3453
DEN,EWR,United Air Lines Inc.,2098,309,11428,0,5564,19399
DEN,FAR,Skywest Airlines Inc.,1211,181,248,0,2982,4622
DEN,FAT,Skywest Airlines Inc.,988,148,228,0,3089,4453
DEN,FCA,Skywest Airlines Inc.,856,125,82,0,1598,2661
DEN,FLL,Frontier Airlines Inc.,947,8,559,0,72,1586
DEN,FLL,United Air Lines Inc.,1340,63,390,0,2183,3976
DEN,FSD,Skywest Airlines Inc.,761,166,274,28,1267,2496
DEN,FSD,United Air Lines Inc.,1388,0,309,0,3264,4961
DEN,GEG,Frontier Airlines Inc.,176,0,231,0,219,626
DEN,GEG,United Air Lines Inc.,2177,144,466,0,2776,5563
DEN,GJT,Skywest Airlines Inc.,643,147,180,0,1197,2167
DEN,GRR,Skywest Airlines Inc.,494,0,237,0,1235,1966
DEN,GRR,United Air Lines Inc.,245,0,89,0,396,730
DEN,GTF,Skywest Airlines Inc.,978,0,126,0,2390,3494
DEN,GUC,Skywest Airlines Inc.,403,85,137,0,518,1143
DEN,GUC,United Air Lines Inc.,363,253,92,0,416,1124
DEN,HDN,Skywest Airlines Inc.,865,22,300,0,3380,4567
DEN,HDN,United Air Lines Inc.,637,75,201,0,922,1835
DEN,HLN,Skywest Airlines Inc.,0,0,15,0,458,473
DEN,HNL,United Air Lines Inc.,1629,86,486,0,413,2614
DEN,HOU,Southwest Airlines Co.,882,129,304,0,2418,3733
DEN,HSV,Skywest Airlines Inc.,446,46,165,0,1030,1687
DEN,IAD,United Air Lines Inc.,7159,277,2848,0,9919,20203
DEN,IAH,Frontier Airlines Inc.,1007,94,1058,0,338,2497
DEN,IAH,Skywest Airlines Inc.,208,49,225,0,844,1326
DEN,IAH,United Air Lines Inc.,2492,238,1382,0,4321,8433
DEN,ICT,Skywest Airlines Inc.,1067,24,339,0,2503,3933
DEN,ICT,United Air Lines Inc.,2947,171,728,0,4456,8302
DEN,IDA,Skywest Airlines Inc.,1141,96,261,0,2286,3784
DEN,IND,Frontier Airlines Inc.,1814,84,1812,0,685,4395
DEN,IND,Southwest Airlines Co.,362,0,18,0,198,578
DEN,IND,United Air Lines Inc.,798,11,234,0,684,1727
DEN,JAC,Frontier Airlines Inc.,66,0,67,0,19,152
DEN,JAC,United Air Lines Inc.,1725,142,592,0,3569,6028
DEN,JAX,Frontier Airlines Inc.,323,0,206,0,97,626
DEN,JFK,Delta Air Lines Inc.,228,0,525,0,715,1468
DEN,JFK,JetBlue Airways,107,0,2275,0,1496,3878
DEN,KOA,United Air Lines Inc.,251,0,21,0,220,492
DEN,LAS,Frontier Airlines Inc.,5777,96,4436,0,1736,12045
DEN,LAS,Southwest Airlines Co.,2088,343,2489,13,10684,15617
DEN,LAS,United Air Lines Inc.,8340,642,5591,0,11862,26435
DEN,LAX,American Airlines Inc.,1106,79,645,0,2481,4311
DEN,LAX,Frontier Airlines Inc.,4948,94,4763,0,1595,11400
DEN,LAX,Southwest Airlines Co.,947,7,397,0,1492,2843
DEN,LAX,United Air Lines Inc.,9081,521,3352,0,16601,29555
DEN,LGA,Frontier Airlines Inc.,8680,73,3045,0,570,12368
DEN,LGA,United Air Lines Inc.,4083,179,12254,0,10790,27306
DEN,LIH,United Air Lines Inc.,163,0,22,0,91,276
DEN,LNK,Skywest Airlines Inc.,1426,0,316,0,3829,5571
DEN,MCI,Frontier Airlines Inc.,1776,22,2454,0,2007,6259
DEN,MCI,Skywest Airlines Inc.,295,0,254,0,466,1015
DEN,MCI,Southwest Airlines Co.,1281,247,399,28,3306,5261
DEN,MCI,United Air Lines Inc.,4188,282,1407,0,9213,15090
DEN,MCO,Frontier Airlines Inc.,1470,15,1205,0,419,3109
DEN,MCO,Southwest Airlines Co.,522,28,323,95,1323,2291
DEN,MCO,United Air Lines Inc.,3823,219,1264,0,4373,9679
DEN,MDW,Frontier Airlines Inc.,2759,95,2214,0,1228,6296
DEN,MDW,Southwest Airlines Co.,2300,1053,1537,35,4666,9591
DEN,MEM,Frontier Airlines Inc.,135,0,9,0,20,164
DEN,MEM,Skywest Airlines Inc.,712,0,214,0,1108,2034
DEN,MFR,Skywest Airlines Inc.,767,112,29,0,607,1515
DEN,MIA,American Airlines Inc.,1597,42,267,0,0,1906
DEN,MIA,United Air Lines Inc.,3276,160,866,0,2392,6694
DEN,MKE,Frontier Airlines Inc.,1334,60,1965,0,881,4240
DEN,MKE,Skywest Airlines Inc.,506,7,126,0,862,1501
DEN,MLI,Skywest Airlines Inc.,297,23,6,0,851,1177
DEN,MRY,Skywest Airlines Inc.,339,80,65,0,362,846
DEN,MSN,Skywest Airlines Inc.,1159,88,288,0,2890,4425
DEN,MSO,Skywest Airlines Inc.,902,90,99,0,2044,3135
DEN,MSO,United Air Lines Inc.,795,16,110,0,998,1919
DEN,MSP,Frontier Airlines Inc.,1752,63,1850,0,662,4327
DEN,MSP,United Air Lines Inc.,3664,238,1717,0,6620,12239
DEN,MSY,United Air Lines Inc.,2717,60,800,0,3538,7115
DEN,MTJ,Skywest Airlines Inc.,0,52,0,0,0,52
DEN,MTJ,United Air Lines Inc.,127,0,23,0,91,241
DEN,OAK,Southwest Airlines Co.,1941,42,948,0,8418,11349
DEN,OAK,United Air Lines Inc.,3552,146,1311,0,7716,12725
DEN,OGG,United Air Lines Inc.,679,7,316,0,518,1520
DEN,OKC,Frontier Airlines Inc.,385,7,921,0,515,1828
DEN,OKC,Skywest Airlines Inc.,374,0,46,0,2341,2761
DEN,OKC,Southwest Airlines Co.,909,30,362,0,1271,2572
DEN,OKC,United Air Lines Inc.,2084,168,650,0,3709,6611
DEN,OMA,Frontier Airlines Inc.,481,94,899,0,425,1899
DEN,OMA,Skywest Airlines Inc.,331,138,201,0,549,1219
DEN,OMA,United Air Lines Inc.,3334,225,1558,0,9429,14546
DEN,ONT,United Air Lines Inc.,3940,177,1344,0,6747,12208
DEN,ORD,American Airlines Inc.,2745,343,11677,0,8741,23506
DEN,ORD,Skywest Airlines Inc.,0,0,253,0,0,253
DEN,ORD,United Air Lines Inc.,11668,344,14759,0,22921,49692
DEN,PBI,Frontier Airlines Inc.,288,0,245,0,39,572
DEN,PDX,Alaska Airlines Inc.,916,60,349,22,1562,2909
DEN,PDX,Frontier Airlines Inc.,2457,88,2923,0,1355,6823
DEN,PDX,Southwest Airlines Co.,152,0,50,0,230,432
DEN,PDX,United Air Lines Inc.,5438,279,1830,0,9481,17028
DEN,PHL,Frontier Airlines Inc.,2153,38,997,0,104,3292
DEN,PHL,Southwest Airlines Co.,401,297,883,6,1048,2635
DEN,PHL,US Airways Inc.,1383,31,1393,0,780,3587
DEN,PHL,United Air Lines Inc.,2743,77,4273,0,5128,12221
DEN,PHX,Frontier Airlines Inc.,2811,57,3329,0,1574,7771
DEN,PHX,Southwest Airlines Co.,1371,96,708,19,5761,7955
DEN,PHX,US Airways Inc.,1621,17,628,0,1866,4132
DEN,PHX,United Air Lines Inc.,5293,236,2073,0,8255,15857
DEN,PIA,Skywest Airlines Inc.,427,38,96,0,326,887
DEN,PIT,Skywest Airlines Inc.,86,17,3,0,584,690
DEN,PIT,United Air Lines Inc.,2676,126,702,0,3825,7329
DEN,PSC,Skywest Airlines Inc.,919,289,234,0,1980,3422
DEN,PSP,Skywest Airlines Inc.,1341,110,368,0,2315,4134
DEN,PSP,United Air Lines Inc.,501,12,193,0,1017,1723
DEN,RAP,Skywest Airlines Inc.,1443,62,340,0,2574,4419
DEN,RDU,Southwest Airlines Co.,348,0,209,0,623,1180
DEN,RDU,United Air Lines Inc.,422,36,272,0,1167,1897
DEN,RFD,Skywest Airlines Inc.,683,0,74,0,1696,2453
DEN,RNO,United Air Lines Inc.,3932,183,1414,0,4361,9890
DEN,RSW,Frontier Airlines Inc.,650,12,787,0,208,1657
DEN,SAN,Frontier Airlines Inc.,3286,98,4158,135,2157,9834
DEN,SAN,Southwest Airlines Co.,564,34,278,0,2440,3316
DEN,SAN,United Air Lines Inc.,5770,212,2396,0,10035,18413
DEN,SAT,Frontier Airlines Inc.,1168,13,1674,0,690,3545
DEN,SAT,Skywest Airlines Inc.,434,75,317,0,1110,1936
DEN,SAT,Southwest Airlines Co.,97,29,124,0,589,839
DEN,SAT,United Air Lines Inc.,1658,51,542,0,2788,5039
DEN,SBA,Skywest Airlines Inc.,1109,0,113,0,2468,3690
DEN,SDF,Frontier Airlines Inc.,504,34,1144,0,380,2062
DEN,SEA,Alaska Airlines Inc.,1821,117,1075,58,2210,5281
DEN,SEA,Frontier Airlines Inc.,2312,24,2217,0,1283,5836
DEN,SEA,Southwest Airlines Co.,1005,36,679,15,6325,8060
DEN,SEA,United Air Lines Inc.,5592,109,2562,0,12286,20549
DEN,SFO,Frontier Airlines Inc.,8354,52,3989,0,1005,13400
DEN,SFO,Skywest Airlines Inc.,65,0,0,0,0,65
DEN,SFO,United Air Lines Inc.,9207,568,10240,0,15368,35383
DEN,SGF,Skywest Airlines Inc.,1086,165,446,7,2420,4124
DEN,SJC,Frontier Airlines Inc.,1501,24,1961,0,980,4466
DEN,SJC,Southwest Airlines Co.,338,37,38,0,925,1338
DEN,SJC,United Air Lines Inc.,3365,243,1984,0,11018,16610
DEN,SLC,Delta Air Lines Inc.,427,0,220,0,568,1215
DEN,SLC,Frontier Airlines Inc.,4280,68,4482,0,1845,10675
DEN,SLC,Skywest Airlines Inc.,3369,539,778,0,6526,11212
DEN,SLC,Southwest Airlines Co.,1577,260,1088,13,9022,11960
DEN,SLC,United Air Lines Inc.,3811,219,1039,0,5821,10890
DEN,SMF,Frontier Airlines Inc.,2262,64,2552,0,833,5711
DEN,SMF,United Air Lines Inc.,3537,230,1691,0,8306,13764
DEN,SNA,Frontier Airlines Inc.,1341,59,1805,0,740,3945
DEN,SNA,United Air Lines Inc.,2934,56,1665,0,5465,10120
DEN,STL,Frontier Airlines Inc.,1723,155,1950,0,1016,4844
DEN,STL,Southwest Airlines Co.,257,61,43,0,945,1306
DEN,STL,United Air Lines Inc.,326,62,441,0,593,1422
DEN,TPA,Frontier Airlines Inc.,872,0,696,0,246,1814
DEN,TPA,Southwest Airlines Co.,625,0,82,0,592,1299
DEN,TPA,United Air Lines Inc.,3112,67,980,0,4112,8271
DEN,TUL,Skywest Airlines Inc.,437,35,166,0,1892,2530
DEN,TUL,United Air Lines Inc.,1740,22,437,0,4263,6462
DEN,TUS,Frontier Airlines Inc.,551,17,907,0,408,1883
DEN,TUS,Skywest Airlines Inc.,1489,0,170,0,2789,4448
DEN,TUS,United Air Lines Inc.,1072,0,267,0,2080,3419
DEN,TYS,Skywest Airlines Inc.,581,48,198,0,2494,3321
DEN,XNA,Skywest Airlines Inc.,447,23,179,0,2010,2659
DFW,ABI,American Eagle Airlines Inc.,6583,3072,2082,0,6527,18264
DFW,ABQ,American Airlines Inc.,8211,1088,2114,0,8610,20023
DFW,ACT,American Eagle Airlines Inc.,5416,1380,1239,0,2748,10783
DFW,AEX,American Eagle Airlines Inc.,2937,809,753,0,1376,5875
DFW,AMA,American Eagle Airlines Inc.,7427,1959,1466,0,7422,18274
DFW,ANC,American Airlines Inc.,961,78,291,0,193,1523
DFW,ATL,American Airlines Inc.,8697,1035,6349,0,8256,24337
DFW,ATL,Atlantic Southeast Airlines,65,0,17,0,78,160
DFW,ATL,Delta Air Lines Inc.,3459,1461,3140,0,7570,15630
DFW,ATL,Skywest Airlines Inc.,0,0,51,0,0,51
DFW,AUS,American Airlines Inc.,13768,2189,3715,0,13473,33145
DFW,BDL,American Airlines Inc.,3614,321,938,0,3139,8012
DFW,BHM,American Airlines Inc.,2592,288,1005,0,2549,6434
DFW,BNA,American Airlines Inc.,6508,1175,2047,0,6444,16174
DFW,BOS,American Airlines Inc.,7576,1254,7124,0,5472,21426
DFW,BTR,American Eagle Airlines Inc.,5953,2459,2262,0,4806,15480
DFW,BUF,American Eagle Airlines Inc.,511,120,47,0,535,1213
DFW,BUR,American Airlines Inc.,3864,390,1500,0,2623,8377
DFW,BWI,American Airlines Inc.,4968,675,1814,0,4006,11463
DFW,CAE,American Eagle Airlines Inc.,2701,680,912,0,2315,6608
DFW,CHA,American Eagle Airlines Inc.,667,148,349,0,714,1878
DFW,CHS,American Eagle Airlines Inc.,2770,501,1175,0,1512,5958
DFW,CID,American Eagle Airlines Inc.,3252,1148,835,0,2853,8088
DFW,CLE,American Eagle Airlines Inc.,5759,634,860,0,3102,10355
DFW,CLL,American Eagle Airlines Inc.,3328,918,786,0,1435,6467
DFW,CLT,American Airlines Inc.,4533,460,1920,0,4144,11057
DFW,CLT,US Airways Inc.,2298,128,609,0,2225,5260
DFW,CMH,American Airlines Inc.,2781,494,770,0,1808,5853
DFW,CMH,American Eagle Airlines Inc.,1444,393,247,0,1369,3453
DFW,CMI,American Eagle Airlines Inc.,1321,779,158,0,483,2741
DFW,COS,American Airlines Inc.,6591,1016,1794,0,4937,14338
DFW,CRP,American Eagle Airlines Inc.,4470,1799,1465,0,3860,11594
DFW,CVG,American Eagle Airlines Inc.,3499,1502,1238,0,3343,9582
DFW,CVG,Skywest Airlines Inc.,139,0,15,0,583,737
DFW,DAY,American Airlines Inc.,2796,291,882,0,2274,6243
DFW,DCA,American Airlines Inc.,11084,2065,4974,0,11165,29288
DFW,DEN,American Airlines Inc.,11602,1718,4468,0,11080,28868
DFW,DEN,Frontier Airlines Inc.,1707,301,2538,0,3014,7560
DFW,DEN,Skywest Airlines Inc.,45,0,0,0,49,94
DFW,DEN,United Air Lines Inc.,3494,195,1707,22,9251,14669
DFW,DSM,American Eagle Airlines Inc.,5739,1433,1141,0,5259,13572
DFW,DTW,American Airlines Inc.,6223,1385,1690,0,5534,14832
DFW,EGE,American Airlines Inc.,3250,625,1046,0,2263,7184
DFW,ELP,American Airlines Inc.,7150,1092,2258,0,9426,19926
DFW,EVV,American Eagle Airlines Inc.,823,265,317,0,635,2040
DFW,EWR,American Airlines Inc.,4201,827,12268,0,5770,23066
DFW,FAT,American Airlines Inc.,2474,415,791,0,1710,5390
DFW,FLL,American Airlines Inc.,7982,1396,2214,0,6009,17601
DFW,FNT,American Eagle Airlines Inc.,541,483,214,0,439,1677
DFW,FSM,American Eagle Airlines Inc.,4050,1310,1209,0,3048,9617
DFW,FWA,American Eagle Airlines Inc.,1295,579,379,0,1920,4173
DFW,GGG,American Eagle Airlines Inc.,3128,672,456,0,1515,5771
DFW,GJT,American Eagle Airlines Inc.,1010,495,204,0,390,2099
DFW,GPT,American Eagle Airlines Inc.,2260,1145,673,0,2177,6255
DFW,GRK,American Eagle Airlines Inc.,10887,2744,1499,0,7730,22860
DFW,GRR,American Eagle Airlines Inc.,1910,918,451,0,1118,4397
DFW,GSO,American Airlines Inc.,113,6,133,0,271,523
DFW,GSO,American Eagle Airlines Inc.,1264,672,490,0,1074,3500
DFW,GSP,American Eagle Airlines Inc.,2987,1002,898,0,2167,7054
DFW,GUC,American Airlines Inc.,1329,32,389,0,687,2437
DFW,HDN,American Airlines Inc.,990,46,263,0,268,1567
DFW,HNL,American Airlines Inc.,2583,299,546,0,28,3456
DFW,HOU,American Eagle Airlines Inc.,5332,2286,1834,0,3801,13253
DFW,HSV,American Airlines Inc.,1617,144,323,0,1630,3714
DFW,HSV,American Eagle Airlines Inc.,3166,1040,639,0,2137,6982
DFW,IAD,American Airlines Inc.,5084,397,1727,0,3292,10500
DFW,IAH,American Airlines Inc.,5777,766,3263,0,4806,14612
DFW,ICT,American Airlines Inc.,3865,1363,1438,0,3558,10224
DFW,ICT,American Eagle Airlines Inc.,654,103,56,0,501,1314
DFW,IND,American Airlines Inc.,5023,958,1854,0,4826,12661
DFW,JAC,American Airlines Inc.,1186,229,91,0,787,2293
DFW,JAN,American Eagle Airlines Inc.,5492,2006,1973,0,5415,14886
DFW,JAX,American Airlines Inc.,3124,895,872,0,2494,7385
DFW,JFK,American Airlines Inc.,2088,298,4105,0,803,7294
DFW,LAS,American Airlines Inc.,13871,1591,6571,0,10014,32047
DFW,LAS,US Airways Inc.,1875,32,868,0,2711,5486
DFW,LAW,American Eagle Airlines Inc.,5709,1153,1115,0,2710,10687
DFW,LAX,American Airlines Inc.,19700,3192,7381,0,11263,41536
DFW,LAX,Skywest Airlines Inc.,1269,1004,397,0,1702,4372
DFW,LBB,American Eagle Airlines Inc.,9595,2218,2420,0,8671,22904
DFW,LEX,American Eagle Airlines Inc.,1735,670,480,0,1271,4156
DFW,LFT,American Eagle Airlines Inc.,3896,1342,1459,0,2278,8975
DFW,LGA,American Airlines Inc.,12187,1437,36627,0,12174,62425
DFW,LIT,American Eagle Airlines Inc.,11345,2513,2415,0,8878,25151
DFW,LRD,American Eagle Airlines Inc.,3912,1418,815,0,3231,9376
DFW,MAF,American Eagle Airlines Inc.,5358,1515,1243,0,4319,12435
DFW,MCI,American Airlines Inc.,8291,727,2385,0,7613,19016
DFW,MCO,American Airlines Inc.,11835,1390,3856,0,7082,24163
DFW,MDT,American Eagle Airlines Inc.,2202,358,88,0,1241,3889
DFW,MEM,American Airlines Inc.,2968,597,1732,0,3607,8904
DFW,MFE,American Airlines Inc.,3257,1088,988,0,3650,8983
DFW,MIA,American Airlines Inc.,15524,1625,5074,0,9276,31499
DFW,MKE,American Eagle Airlines Inc.,1401,193,328,0,524,2446
DFW,MLI,American Eagle Airlines Inc.,867,388,217,0,640,2112
DFW,MLU,American Eagle Airlines Inc.,2036,1217,461,0,1202,4916
DFW,MOB,American Eagle Airlines Inc.,2486,960,1277,0,2203,6926
DFW,MSN,American Eagle Airlines Inc.,1810,581,420,0,1747,4558
DFW,MSP,American Airlines Inc.,5493,1037,2626,0,5800,14956
DFW,MSY,American Airlines Inc.,7443,1234,3189,0,5411,17277
DFW,MTJ,American Airlines Inc.,242,11,107,0,52,412
DFW,MTJ,American Eagle Airlines Inc.,1078,103,204,0,750,2135
DFW,OAK,American Airlines Inc.,3088,580,1385,0,2524,7577
DFW,OGG,American Airlines Inc.,974,331,172,0,52,1529
DFW,OKC,American Airlines Inc.,6588,1982,1282,0,5823,15675
DFW,OKC,American Eagle Airlines Inc.,548,393,258,0,333,1532
DFW,OMA,American Airlines Inc.,4438,1158,1576,0,4920,12092
DFW,ONT,American Airlines Inc.,5440,1025,2306,0,4481,13252
DFW,ORD,American Airlines Inc.,10560,2029,29619,0,19115,61323
DFW,ORD,Skywest Airlines Inc.,409,60,2172,0,1000,3641
DFW,ORD,United Air Lines Inc.,1745,395,10352,43,8097,20632
DFW,ORF,American Airlines Inc.,2276,418,635,0,1115,4444
DFW,ORF,American Eagle Airlines Inc.,1662,177,375,0,969,3183
DFW,PBI,American Airlines Inc.,2106,316,912,0,1795,5129
DFW,PDX,American Airlines Inc.,5009,893,2041,0,2893,10836
DFW,PHL,American Airlines Inc.,6050,908,10505,0,5618,23081
DFW,PHL,US Airways Inc.,1243,346,4834,0,2250,8673
DFW,PHX,American Airlines Inc.,10201,1538,3038,0,7113,21890
DFW,PHX,US Airways Inc.,2228,626,902,24,3220,7000
DFW,PIA,American Eagle Airlines Inc.,1466,251,535,0,1697,3949
DFW,PIT,American Eagle Airlines Inc.,8577,1635,1641,0,4907,16760
DFW,PNS,American Eagle Airlines Inc.,4831,2801,1472,0,3231,12335
DFW,PSP,American Airlines Inc.,4166,304,1506,0,2788,8764
DFW,RDU,American Airlines Inc.,6331,823,2405,0,4815,14374
DFW,RIC,American Airlines Inc.,2611,586,1422,0,2367,6986
DFW,RNO,American Airlines Inc.,4679,291,1691,0,4024,10685
DFW,ROC,American Eagle Airlines Inc.,590,80,104,0,476,1250
DFW,ROW,American Eagle Airlines Inc.,1870,622,562,0,1740,4794
DFW,RSW,American Airlines Inc.,2602,865,882,0,1376,5725
DFW,SAN,American Airlines Inc.,12313,1989,4562,0,9548,28412
DFW,SAT,American Airlines Inc.,14491,2239,4364,0,15445,36539
DFW,SAV,American Eagle Airlines Inc.,1960,647,541,0,1680,4828
DFW,SBA,American Eagle Airlines Inc.,1326,408,492,0,1004,3230
DFW,SDF,American Airlines Inc.,2453,317,583,0,1706,5059
DFW,SDF,American Eagle Airlines Inc.,1285,219,383,0,302,2189
DFW,SEA,Alaska Airlines Inc.,1188,657,548,17,2551,4961
DFW,SEA,American Airlines Inc.,10378,1393,4764,0,6517,23052
DFW,SFO,American Airlines Inc.,11626,2266,14311,0,6926,35129
DFW,SFO,United Air Lines Inc.,1217,44,540,0,1315,3116
DFW,SGF,American Eagle Airlines Inc.,9056,4110,1966,0,5824,20956
DFW,SHV,American Eagle Airlines Inc.,11349,2665,2584,0,5757,22355
DFW,SJC,American Airlines Inc.,5502,943,2339,0,5094,13878
DFW,SJT,American Eagle Airlines Inc.,4297,979,980,0,2471,8727
DFW,SJU,American Airlines Inc.,5510,590,1749,0,2386,10235
DFW,SLC,American Airlines Inc.,7195,1058,2360,0,4072,14685
DFW,SLC,Delta Air Lines Inc.,1582,67,240,0,907,2796
DFW,SLC,Skywest Airlines Inc.,1046,484,86,0,2444,4060
DFW,SMF,American Airlines Inc.,4365,587,1790,0,3109,9851
DFW,SNA,American Airlines Inc.,9871,1155,4564,10,7202,22802
DFW,SPS,American Eagle Airlines Inc.,6734,1625,1175,0,2864,12398
DFW,STL,American Airlines Inc.,9752,1471,2488,0,8675,22386
DFW,SYR,American Eagle Airlines Inc.,386,142,64,0,190,782
DFW,TPA,American Airlines Inc.,8017,1429,3026,0,6651,19123
DFW,TUL,American Airlines Inc.,7240,1056,1488,0,6573,16357
DFW,TUL,American Eagle Airlines Inc.,4082,1131,500,0,2242,7955
DFW,TUS,American Airlines Inc.,8989,1433,2772,0,8416,21610
DFW,TXK,American Eagle Airlines Inc.,2796,1318,1089,0,1690,6893
DFW,TYR,American Eagle Airlines Inc.,4254,1358,774,0,1973,8359
DFW,TYS,American Eagle Airlines Inc.,4519,1193,1381,0,3099,10192
DFW,VPS,American Eagle Airlines Inc.,3693,1159,1770,0,4011,10633
DFW,XNA,American Airlines Inc.,1837,305,509,0,3160,5811
DFW,XNA,American Eagle Airlines Inc.,6986,1984,1393,0,4848,15211
DHN,ATL,Atlantic Southeast Airlines,5517,1927,2303,20,462,10229
DLG,ANC,Alaska Airlines Inc.,10,0,42,0,400,452
DRO,ABQ,Skywest Airlines Inc.,0,0,0,0,46,46
DRO,DEN,Skywest Airlines Inc.,1223,1405,294,0,924,3846
DRO,SLC,Skywest Airlines Inc.,549,332,0,0,371,1252
DSM,ATL,Atlantic Southeast Airlines,4566,1894,1241,0,458,8159
DSM,DEN,Skywest Airlines Inc.,352,5,541,0,3057,3955
DSM,DEN,United Air Lines Inc.,3893,150,1055,0,2748,7846
DSM,DFW,American Eagle Airlines Inc.,3717,415,1617,0,8019,13768
DSM,LAX,Skywest Airlines Inc.,226,20,49,20,0,315
DSM,LGA,American Eagle Airlines Inc.,714,0,249,0,323,1286
DSM,MKE,Skywest Airlines Inc.,849,142,193,0,203,1387
DSM,ORD,American Eagle Airlines Inc.,3932,767,10430,0,11851,26980
DSM,ORD,Skywest Airlines Inc.,396,0,3805,0,2811,7012
DSM,ORD,United Air Lines Inc.,345,157,3988,0,2466,6956
DSM,SLC,Skywest Airlines Inc.,0,0,0,0,116,116
DTW,ATL,Atlantic Southeast Airlines,5187,1524,2093,0,837,9641
DTW,ATL,Delta Air Lines Inc.,1007,56,847,0,1416,3326
DTW,ATL,Skywest Airlines Inc.,114,182,115,0,493,904
DTW,BNA,Southwest Airlines Co.,959,507,1017,114,2314,4911
DTW,BWI,Southwest Airlines Co.,567,533,1327,204,2279,4910
DTW,CLT,US Airways Inc.,180,0,11,0,17,208
DTW,DEN,Frontier Airlines Inc.,350,44,1553,0,1029,2976
DTW,DEN,Skywest Airlines Inc.,0,5,225,0,802,1032
DTW,DEN,United Air Lines Inc.,1856,128,624,0,3808,6416
DTW,DFW,American Airlines Inc.,1811,879,3622,55,6232,12599
DTW,LAS,US Airways Inc.,632,59,396,0,990,2077
DTW,LGA,American Eagle Airlines Inc.,706,150,8221,0,8267,17344
DTW,MCO,Southwest Airlines Co.,453,355,592,0,1564,2964
DTW,MDW,Southwest Airlines Co.,1660,2771,4329,203,9938,18901
DTW,MIA,American Airlines Inc.,767,94,712,6,819,2398
DTW,ORD,American Airlines Inc.,2971,293,4157,0,3137,10558
DTW,ORD,American Eagle Airlines Inc.,346,78,4161,12,6718,11315
DTW,ORD,Skywest Airlines Inc.,27,168,1671,0,688,2554
DTW,ORD,United Air Lines Inc.,3064,248,7178,37,6680,17207
DTW,PHL,US Airways Inc.,35,7,712,9,0,763
DTW,PHX,Southwest Airlines Co.,561,70,431,0,1666,2728
DTW,PHX,US Airways Inc.,1902,141,762,101,368,3274
DTW,SLC,Delta Air Lines Inc.,679,31,355,0,741,1806
DTW,SLC,Skywest Airlines Inc.,0,0,0,0,353,353
DTW,STL,Southwest Airlines Co.,965,115,1058,36,4514,6688
EGE,ATL,Delta Air Lines Inc.,340,10,251,0,877,1478
EGE,CLT,US Airways Inc.,92,0,47,0,186,325
EGE,CVG,Delta Air Lines Inc.,16,49,181,0,346,592
EGE,DEN,United Air Lines Inc.,725,626,651,0,1976,3978
EGE,DFW,American Airlines Inc.,1742,2669,863,0,3854,9128
EGE,EWR,American Airlines Inc.,1498,239,539,0,208,2484
EGE,LAX,American Airlines Inc.,1236,45,307,0,3162,4750
EGE,LGA,American Airlines Inc.,90,0,81,0,315,486
EGE,MIA,American Airlines Inc.,1212,374,797,0,501,2884
EGE,ORD,American Airlines Inc.,622,254,2153,0,1593,4622
EGE,ORD,United Air Lines Inc.,56,0,0,0,0,56
EKO,SLC,Skywest Airlines Inc.,1646,48,115,123,2383,4315
ELP,ABQ,Southwest Airlines Co.,270,36,77,6,1584,1973
ELP,ATL,Delta Air Lines Inc.,1840,142,297,0,163,2442
ELP,AUS,Southwest Airlines Co.,548,71,124,0,3748,4491
ELP,DAL,Southwest Airlines Co.,1762,287,302,23,4739,7113
ELP,DEN,Skywest Airlines Inc.,445,0,103,28,1120,1696
ELP,DFW,American Airlines Inc.,3106,774,2236,9,5163,11288
ELP,HOU,Southwest Airlines Co.,701,107,477,0,3157,4442
ELP,LAS,Southwest Airlines Co.,452,0,532,0,1431,2415
ELP,LAX,Southwest Airlines Co.,893,9,960,0,2961,4823
ELP,LBB,Southwest Airlines Co.,575,18,118,0,2030,2741
ELP,ORD,American Airlines Inc.,1037,0,4363,0,1680,7080
ELP,PHX,Southwest Airlines Co.,1911,188,1797,6,11283,15185
ELP,PHX,US Airways Inc.,683,0,277,0,538,1498
ELP,SAN,Southwest Airlines Co.,53,0,102,0,1052,1207
ELP,SAT,Southwest Airlines Co.,745,6,196,0,3568,4515
ELP,SLC,Skywest Airlines Inc.,0,0,268,0,206,474
EUG,DEN,Skywest Airlines Inc.,813,83,87,0,383,1366
EUG,PDX,Skywest Airlines Inc.,581,142,6,0,1082,1811
EUG,SFO,Skywest Airlines Inc.,2945,101,8781,0,4086,15913
EUG,SFO,United Air Lines Inc.,660,0,2628,0,2398,5686
EUG,SLC,Skywest Airlines Inc.,267,111,0,17,380,775
EVV,ATL,Atlantic Southeast Airlines,3751,1888,1345,8,518,7510
EVV,CVG,Atlantic Southeast Airlines,0,0,49,0,0,49
EVV,DFW,American Eagle Airlines Inc.,0,142,358,0,1662,2162
EVV,ORD,American Eagle Airlines Inc.,996,381,7771,0,8084,17232
EWN,ATL,Atlantic Southeast Airlines,2794,1142,1247,0,174,5357
EWR,ATL,Atlantic Southeast Airlines,895,3806,2862,0,106,7669
EWR,ATL,Delta Air Lines Inc.,4083,129,5580,0,10321,20113
EWR,CLT,US Airways Inc.,3001,98,1663,0,8165,12927
EWR,CVG,Atlantic Southeast Airlines,173,99,39,0,32,343
EWR,DEN,United Air Lines Inc.,1367,112,1510,0,7235,10224
EWR,DFW,American Airlines Inc.,2751,535,2997,0,8304,14587
EWR,EGE,American Airlines Inc.,914,154,511,0,2595,4174
EWR,FLL,JetBlue Airways,1456,33,1844,4,11691,15028
EWR,LAS,US Airways Inc.,898,0,472,0,2669,4039
EWR,LAX,American Airlines Inc.,1887,162,1989,7,3263,7308
EWR,LAX,United Air Lines Inc.,286,28,179,0,471,964
EWR,MCO,JetBlue Airways,1472,7,1730,0,13639,16848
EWR,MIA,American Airlines Inc.,2659,238,2380,0,6873,12150
EWR,MKE,Skywest Airlines Inc.,2596,3900,16963,0,356,23815
EWR,ORD,American Airlines Inc.,1389,359,10619,0,11028,23395
EWR,ORD,United Air Lines Inc.,3281,379,11464,0,21068,36192
EWR,PBI,JetBlue Airways,1237,0,664,1,6840,8742
EWR,PHX,US Airways Inc.,2226,11,740,0,3354,6331
EWR,RDU,American Eagle Airlines Inc.,2343,168,2726,0,8866,14103
EWR,RSW,JetBlue Airways,723,20,291,0,192,1226
EWR,SEA,Alaska Airlines Inc.,1381,270,667,40,2259,4617
EWR,SFO,United Air Lines Inc.,1389,326,1788,0,3659,7162
EWR,SJU,American Airlines Inc.,776,33,152,11,0,972
EWR,SLC,Delta Air Lines Inc.,1182,0,992,0,2321,4495
EWR,TPA,JetBlue Airways,287,0,273,0,1230,1790
EYW,ATL,Atlantic Southeast Airlines,4853,2688,1812,0,448,9801
EYW,MCO,Atlantic Southeast Airlines,36,0,0,0,47,83
FAI,ANC,Alaska Airlines Inc.,2498,36,670,0,3859,7063
FAI,BRW,Alaska Airlines Inc.,364,0,22,0,857,1243
FAI,SCC,Alaska Airlines Inc.,142,5,52,0,517,716
FAI,SEA,Alaska Airlines Inc.,2154,31,213,0,605,3003
FAI,SLC,Delta Air Lines Inc.,0,0,0,0,28,28
FAR,DEN,Skywest Airlines Inc.,1228,33,405,0,3827,5493
FAR,MCI,Skywest Airlines Inc.,0,0,0,0,46,46
FAR,ORD,Skywest Airlines Inc.,796,779,15272,0,1831,18678
FAR,SLC,Skywest Airlines Inc.,38,0,0,0,406,444
FAT,DEN,Skywest Airlines Inc.,2621,430,153,0,441,3645
FAT,DFW,American Airlines Inc.,764,298,177,0,1121,2360
FAT,LAS,Skywest Airlines Inc.,2455,270,1532,0,591,4848
FAT,LAS,US Airways Inc.,295,70,94,0,381,840
FAT,LAX,American Eagle Airlines Inc.,1826,278,318,0,938,3360
FAT,LAX,Skywest Airlines Inc.,5491,192,1332,0,1378,8393
FAT,SFO,Skywest Airlines Inc.,3338,1346,16330,0,2236,23250
FAT,SLC,Skywest Airlines Inc.,1340,274,162,0,881,2657
FAY,ATL,Atlantic Southeast Airlines,7155,3149,3307,7,790,14408
FCA,ATL,Delta Air Lines Inc.,9,0,2,0,15,26
FCA,DEN,Skywest Airlines Inc.,749,0,73,0,875,1697
FCA,ORD,Skywest Airlines Inc.,189,41,2053,0,123,2406
FCA,SFO,Skywest Airlines Inc.,189,0,56,0,0,245
FCA,SLC,Skywest Airlines Inc.,1053,592,56,90,2058,3849
FLL,ATL,Delta Air Lines Inc.,2691,266,5668,0,6761,15386
FLL,AUS,JetBlue Airways,7,0,8,0,33,48
FLL,AUS,Southwest Airlines Co.,69,0,146,0,155,370
FLL,BDL,Delta Air Lines Inc.,475,10,460,0,2550,3495
FLL,BNA,Southwest Airlines Co.,411,174,434,59,1798,2876
FLL,BOS,Delta Air Lines Inc.,2094,14,1956,0,4267,8331
FLL,BOS,JetBlue Airways,1923,237,4811,10,10837,17818
FLL,BUF,JetBlue Airways,730,210,359,4,1991,3294
FLL,BUF,Southwest Airlines Co.,747,0,168,22,1590,2527
FLL,BWI,Southwest Airlines Co.,1958,497,1253,87,5147,8942
FLL,CLT,JetBlue Airways,503,89,642,19,1277,2530
FLL,CLT,US Airways Inc.,2692,105,1492,73,4367,8729
FLL,CVG,Delta Air Lines Inc.,405,0,900,0,1732,3037
FLL,DCA,US Airways Inc.,674,264,713,39,2539,4229
FLL,DEN,Frontier Airlines Inc.,1484,41,1412,0,447,3384
FLL,DEN,United Air Lines Inc.,1735,58,397,0,1428,3618
FLL,DFW,American Airlines Inc.,4626,643,2646,48,7036,14999
FLL,EWR,JetBlue Airways,2171,432,10729,0,5782,19114
FLL,HOU,Southwest Airlines Co.,840,290,597,67,1449,3243
FLL,HPN,JetBlue Airways,1217,132,913,0,2892,5154
FLL,IAD,JetBlue Airways,1315,74,962,0,2144,4495
FLL,IAD,United Air Lines Inc.,432,25,690,0,1868,3015
FLL,ISP,Southwest Airlines Co.,2225,467,777,28,2567,6064
FLL,JAX,Southwest Airlines Co.,1858,509,1705,51,7671,11794
FLL,JFK,Delta Air Lines Inc.,855,8,3775,0,3853,8491
FLL,JFK,JetBlue Airways,5381,1021,15729,28,12177,34336
FLL,LAS,Delta Air Lines Inc.,96,0,374,0,735,1205
FLL,LAS,US Airways Inc.,661,0,358,22,1055,2096
FLL,LAX,American Airlines Inc.,2494,42,771,0,1208,4515
FLL,LAX,Delta Air Lines Inc.,44,0,54,0,0,98
FLL,LGA,American Airlines Inc.,1037,44,1672,0,1513,4266
FLL,LGA,Delta Air Lines Inc.,1493,13,5031,0,5539,12076
FLL,LGA,JetBlue Airways,1771,195,13049,1,10626,25642
FLL,LGB,JetBlue Airways,181,0,247,0,168,596
FLL,MCO,Southwest Airlines Co.,2050,467,2124,127,7609,12377
FLL,MDW,Southwest Airlines Co.,1352,324,1371,71,5252,8370
FLL,MEM,Frontier Airlines Inc.,54,0,54,0,5,113
FLL,MHT,Southwest Airlines Co.,121,0,218,0,546,885
FLL,MSY,Southwest Airlines Co.,621,64,187,25,986,1883
FLL,OAK,JetBlue Airways,18,0,7,0,135,160
FLL,ORD,American Airlines Inc.,1607,68,7596,0,3135,12406
FLL,ORD,United Air Lines Inc.,2194,104,2316,0,2317,6931
FLL,PHL,Southwest Airlines Co.,1232,1175,2626,27,3174,8234
FLL,PHL,US Airways Inc.,3422,242,4441,0,3625,11730
FLL,PHX,US Airways Inc.,1051,207,431,10,1083,2782
FLL,PIT,US Airways Inc.,123,109,297,9,1592,2130
FLL,PNS,Atlantic Southeast Airlines,423,7,150,0,0,580
FLL,PSE,JetBlue Airways,24,0,0,0,328,352
FLL,PVD,Southwest Airlines Co.,474,17,550,0,1144,2185
FLL,RDU,JetBlue Airways,117,199,175,0,992,1483
FLL,RDU,Southwest Airlines Co.,327,0,89,28,747,1191
FLL,RIC,JetBlue Airways,537,24,310,13,1690,2574
FLL,SJU,American Airlines Inc.,5173,320,805,27,1720,8045
FLL,SLC,Delta Air Lines Inc.,515,14,51,0,215,795
FLL,STL,American Airlines Inc.,0,165,91,0,426,682
FLL,STL,Southwest Airlines Co.,1432,0,361,4,1489,3286
FLL,SWF,JetBlue Airways,464,196,172,0,2828,3660
FLL,SYR,JetBlue Airways,522,91,324,0,1325,2262
FLL,TLH,Atlantic Southeast Airlines,82,24,23,0,0,129
FLL,TPA,Southwest Airlines Co.,3330,721,2594,71,8559,15275
FLO,ATL,Atlantic Southeast Airlines,1011,201,901,20,441,2574
FNT,ATL,Atlantic Southeast Airlines,6884,1952,2881,8,386,12111
FNT,DFW,American Eagle Airlines Inc.,1219,252,364,0,0,1835
FNT,LGA,American Eagle Airlines Inc.,513,144,393,0,0,1050
FNT,MKE,Skywest Airlines Inc.,1094,360,350,50,602,2456
FNT,ORD,American Eagle Airlines Inc.,754,143,7324,0,6023,14244
FSD,ATL,Atlantic Southeast Airlines,348,295,74,0,3,720
FSD,DEN,Skywest Airlines Inc.,945,191,839,0,6339,8314
FSD,DEN,United Air Lines Inc.,831,131,358,0,1931,3251
FSD,ORD,Skywest Airlines Inc.,410,1288,15321,0,1725,18744
FSD,SLC,Skywest Airlines Inc.,0,138,7,0,35,180
FSM,ATL,Atlantic Southeast Airlines,1557,1421,551,0,89,3618
FSM,DFW,American Eagle Airlines Inc.,1664,412,2645,0,5214,9935
FWA,ATL,Atlantic Southeast Airlines,4337,737,1544,17,732,7367
FWA,DFW,American Eagle Airlines Inc.,2316,19,734,0,1131,4200
FWA,ORD,American Eagle Airlines Inc.,1917,47,7909,0,7187,17060
FWA,ORD,Skywest Airlines Inc.,657,357,7225,0,1347,9586
GEG,BOI,Southwest Airlines Co.,1013,7,153,26,2282,3481
GEG,DEN,Frontier Airlines Inc.,59,80,125,0,48,312
GEG,DEN,United Air Lines Inc.,2165,230,406,0,1805,4606
GEG,LAS,Southwest Airlines Co.,192,267,294,0,1437,2190
GEG,OAK,Southwest Airlines Co.,991,119,157,26,1579,2872
GEG,ORD,United Air Lines Inc.,386,126,521,0,34,1067
GEG,PDX,Southwest Airlines Co.,959,222,344,32,4088,5645
GEG,PHX,US Airways Inc.,1109,218,100,0,347,1774
GEG,SEA,Alaska Airlines Inc.,2652,581,1554,59,2972,7818
GEG,SEA,Skywest Airlines Inc.,901,546,25,0,889,2361
GEG,SEA,Southwest Airlines Co.,1070,474,427,97,4413,6481
GEG,SLC,Delta Air Lines Inc.,511,51,452,0,611,1625
GEG,SLC,Skywest Airlines Inc.,1557,567,123,0,1326,3573
GEG,SLC,Southwest Airlines Co.,115,7,158,0,763,1043
GGG,DFW,American Eagle Airlines Inc.,3233,838,589,0,1791,6451
GJT,ASE,Skywest Airlines Inc.,0,0,0,0,111,111
GJT,DEN,Skywest Airlines Inc.,229,215,564,0,1410,2418
GJT,DFW,American Eagle Airlines Inc.,570,333,126,20,553,1602
GJT,LAX,Skywest Airlines Inc.,25,0,0,0,26,51
GJT,ORD,Skywest Airlines Inc.,98,0,0,0,48,146
GJT,SLC,Skywest Airlines Inc.,159,267,58,0,1239,1723
GNV,ATL,Atlantic Southeast Airlines,6249,2576,3015,0,693,12533
GPT,ATL,Atlantic Southeast Airlines,6261,1837,3018,0,1484,12600
GPT,ATL,Delta Air Lines Inc.,743,0,868,0,1081,2692
GPT,DFW,American Eagle Airlines Inc.,4560,1058,979,0,3956,10553
GPT,ORD,American Eagle Airlines Inc.,415,614,964,0,1851,3844
GRB,ATL,Atlantic Southeast Airlines,156,224,208,4,33,625
GRB,CVG,Atlantic Southeast Airlines,1462,277,361,0,153,2253
GRB,DEN,Skywest Airlines Inc.,0,0,0,0,35,35
GRB,GTF,Skywest Airlines Inc.,18,0,0,0,0,18
GRB,MKE,Skywest Airlines Inc.,1530,254,285,0,254,2323
GRB,MQT,American Eagle Airlines Inc.,803,1087,222,0,5537,7649
GRB,ORD,American Eagle Airlines Inc.,359,391,7202,0,10033,17985
GRB,ORD,Skywest Airlines Inc.,234,343,9336,0,1587,11500
GRB,SDF,Skywest Airlines Inc.,0,0,0,0,45,45
GRK,ATL,Atlantic Southeast Airlines,1850,201,1291,10,635,3987
GRK,DFW,American Eagle Airlines Inc.,5347,1732,2331,0,11187,20597
GRR,ATL,Atlantic Southeast Airlines,5543,1228,3011,0,466,10248
GRR,CVG,Atlantic Southeast Airlines,52,65,15,0,40,172
GRR,DEN,Skywest Airlines Inc.,880,46,159,0,499,1584
GRR,DEN,United Air Lines Inc.,261,0,20,0,0,281
GRR,DFW,American Eagle Airlines Inc.,928,502,495,0,1285,3210
GRR,MKE,Skywest Airlines Inc.,3264,1213,596,0,560,5633
GRR,ORD,American Eagle Airlines Inc.,1228,614,7878,0,11921,21641
GRR,ORD,Skywest Airlines Inc.,170,133,2828,0,459,3590
GRR,ORD,United Air Lines Inc.,2118,142,5035,0,4156,11451
GSO,ATL,Atlantic Southeast Airlines,4656,1218,3078,0,938,9890
GSO,ATL,Delta Air Lines Inc.,483,124,215,0,84,906
GSO,DFW,American Airlines Inc.,187,0,66,0,473,726
GSO,DFW,American Eagle Airlines Inc.,1071,80,765,0,1429,3345
GSO,MIA,American Eagle Airlines Inc.,1996,115,185,0,205,2501
GSO,ORD,United Air Lines Inc.,1708,168,1945,0,1633,5454
GSP,ATL,Atlantic Southeast Airlines,2551,1170,2251,0,690,6662
GSP,ATL,Delta Air Lines Inc.,111,172,167,0,42,492
GSP,ATL,Skywest Airlines Inc.,142,223,514,0,1370,2249
GSP,DFW,American Eagle Airlines Inc.,816,260,1122,12,4497,6707
GSP,ORD,American Eagle Airlines Inc.,986,96,3183,0,2826,7091
GTF,DEN,Skywest Airlines Inc.,306,94,205,0,1343,1948
GTF,ORD,Skywest Airlines Inc.,61,0,265,0,0,326
GTF,SLC,Skywest Airlines Inc.,182,7,60,0,1052,1301
GTR,ATL,Atlantic Southeast Airlines,3459,733,1954,8,277,6431
GUC,DEN,Skywest Airlines Inc.,790,1135,134,29,605,2693
GUC,DEN,United Air Lines Inc.,90,150,212,0,896,1348
GUC,DFW,American Airlines Inc.,1236,902,253,17,1694,4102
HDN,ATL,Delta Air Lines Inc.,330,122,340,0,761,1553
HDN,DEN,Skywest Airlines Inc.,597,1201,373,0,2566,4737
HDN,DEN,United Air Lines Inc.,122,413,130,0,102,767
HDN,DFW,American Airlines Inc.,1396,19,233,0,1280,2928
HDN,JFK,Delta Air Lines Inc.,17,0,11,0,65,93
HDN,LGA,Delta Air Lines Inc.,0,0,7,0,258,265
HDN,ORD,American Airlines Inc.,3018,60,1621,0,1525,6224
HDN,ORD,Skywest Airlines Inc.,418,94,2402,0,1050,3964
HDN,SLC,Skywest Airlines Inc.,1025,71,15,0,1437,2548
HHH,ATL,Atlantic Southeast Airlines,3838,1451,1153,31,570,7043
HLN,DEN,Skywest Airlines Inc.,235,16,93,0,130,474
HLN,SLC,Skywest Airlines Inc.,544,477,215,0,1495,2731
HNL,ANC,Alaska Airlines Inc.,508,0,44,0,469,1021
HNL,ATL,Delta Air Lines Inc.,1196,0,267,0,1938,3401
HNL,DEN,United Air Lines Inc.,582,0,21,0,0,603
HNL,DFW,American Airlines Inc.,1071,0,388,0,4714,6173
HNL,ITO,Hawaiian Airlines Inc.,1208,0,0,0,1039,2247
HNL,KOA,Hawaiian Airlines Inc.,1394,0,0,0,1181,2575
HNL,LAS,Hawaiian Airlines Inc.,2684,0,0,0,1144,3828
HNL,LAX,American Airlines Inc.,3147,0,1182,0,4914,9243
HNL,LAX,Delta Air Lines Inc.,402,0,267,0,3338,4007
HNL,LAX,Hawaiian Airlines Inc.,2999,0,7,0,874,3880
HNL,LAX,United Air Lines Inc.,1258,0,208,0,2710,4176
HNL,LIH,Hawaiian Airlines Inc.,2310,0,0,0,2270,4580
HNL,OGG,Hawaiian Airlines Inc.,2292,0,6,0,1899,4197
HNL,ORD,American Airlines Inc.,104,13,91,0,403,611
HNL,ORD,United Air Lines Inc.,1217,0,83,0,321,1621
HNL,PDX,Hawaiian Airlines Inc.,654,0,0,32,140,826
HNL,PHX,Hawaiian Airlines Inc.,5167,0,0,0,1620,6787
HNL,PHX,US Airways Inc.,1561,0,254,0,2118,3933
HNL,SAN,Hawaiian Airlines Inc.,649,0,0,17,87,753
HNL,SAN,United Air Lines Inc.,11,0,5,0,211,227
HNL,SEA,Alaska Airlines Inc.,610,0,178,0,242,1030
HNL,SEA,Hawaiian Airlines Inc.,1542,0,0,0,77,1619
HNL,SFO,American Airlines Inc.,659,0,201,12,1750,2622
HNL,SFO,Hawaiian Airlines Inc.,1187,0,0,0,36,1223
HNL,SFO,United Air Lines Inc.,1712,0,359,0,3120,5191
HNL,SJC,Hawaiian Airlines Inc.,772,0,0,0,133,905
HNL,SLC,Delta Air Lines Inc.,128,0,138,0,414,680
HNL,SMF,Hawaiian Airlines Inc.,1226,0,0,0,73,1299
HOU,ABQ,Southwest Airlines Co.,3268,119,571,21,4188,8167
HOU,ATL,Atlantic Southeast Airlines,561,182,392,0,99,1234
HOU,ATL,Delta Air Lines Inc.,279,23,375,0,747,1424
HOU,ATL,Skywest Airlines Inc.,59,0,0,0,52,111
HOU,AUS,Southwest Airlines Co.,4500,485,878,19,8675,14557
HOU,BHM,Southwest Airlines Co.,1306,189,168,0,2077,3740
HOU,BNA,Southwest Airlines Co.,2768,337,616,0,6713,10434
HOU,BWI,Southwest Airlines Co.,2166,577,716,6,3989,7454
HOU,CRP,Southwest Airlines Co.,2475,248,759,0,10426,13908
HOU,DAL,Southwest Airlines Co.,11820,5001,9759,25,43743,70348
HOU,DEN,Southwest Airlines Co.,1585,358,813,24,5090,7870
HOU,DFW,American Eagle Airlines Inc.,790,1821,2297,10,10023,14941
HOU,ELP,Southwest Airlines Co.,1716,70,496,0,7025,9307
HOU,FLL,Southwest Airlines Co.,1168,121,224,0,3192,4705
HOU,HRL,Southwest Airlines Co.,3816,652,1506,0,17088,23062
HOU,JAN,Southwest Airlines Co.,2663,305,510,20,3994,7492
HOU,JAX,Southwest Airlines Co.,683,55,94,0,2003,2835
HOU,JFK,JetBlue Airways,1390,0,2652,0,1598,5640
HOU,LAS,Southwest Airlines Co.,2318,716,1456,0,4234,8724
HOU,LAX,Southwest Airlines Co.,2518,209,1074,8,5161,8970
HOU,LIT,Southwest Airlines Co.,754,167,340,0,910,2171
HOU,MAF,Southwest Airlines Co.,2104,93,238,0,2976,5411
HOU,MCO,Southwest Airlines Co.,2348,355,634,0,7360,10697
HOU,MDW,Southwest Airlines Co.,3397,1031,1609,0,5781,11818
HOU,MSY,Southwest Airlines Co.,5817,580,1473,6,12007,19883
HOU,OAK,Southwest Airlines Co.,1220,41,538,3,2550,4352
HOU,OKC,Southwest Airlines Co.,2809,337,665,18,4859,8688
HOU,PHL,Southwest Airlines Co.,1350,1005,2519,31,3070,7975
HOU,PHX,Southwest Airlines Co.,3885,115,957,0,5237,10194
HOU,SAN,Southwest Airlines Co.,865,0,258,0,1887,3010
HOU,SAT,Southwest Airlines Co.,4441,315,1616,0,14401,20773
HOU,STL,Southwest Airlines Co.,2488,86,420,0,3204,6198
HOU,TPA,Southwest Airlines Co.,2094,126,458,11,6555,9244
HOU,TUL,Southwest Airlines Co.,2869,100,872,0,5568,9409
HPN,ATL,Atlantic Southeast Airlines,2283,2151,1729,0,1813,7976
HPN,FLL,JetBlue Airways,1561,367,693,21,1488,4130
HPN,MCO,JetBlue Airways,783,365,507,0,1009,2664
HPN,ORD,American Eagle Airlines Inc.,4204,688,9417,0,6129,20438
HPN,ORD,Skywest Airlines Inc.,930,346,12821,0,1569,15666
HPN,PBI,JetBlue Airways,304,35,357,0,1173,1869
HPN,RSW,JetBlue Airways,1051,139,458,0,0,1648
HRL,AUS,Southwest Airlines Co.,82,0,77,0,1244,1403
HRL,DAL,Southwest Airlines Co.,0,0,0,0,37,37
HRL,HOU,Southwest Airlines Co.,2227,594,1874,0,15398,20093
HRL,SAT,Southwest Airlines Co.,285,0,89,0,3045,3419
HSV,ATL,Atlantic Southeast Airlines,2242,2764,1778,34,1042,7860
HSV,ATL,Delta Air Lines Inc.,1405,0,712,43,27,2187
HSV,ATL,Skywest Airlines Inc.,194,0,686,0,343,1223
HSV,CVG,Atlantic Southeast Airlines,63,197,39,0,170,469
HSV,DCA,Atlantic Southeast Airlines,223,259,0,0,107,589
HSV,DEN,Skywest Airlines Inc.,399,23,545,0,658,1625
HSV,DFW,American Airlines Inc.,1082,140,491,0,849,2562
HSV,DFW,American Eagle Airlines Inc.,1088,1101,1051,0,3941,7181
HSV,MCO,Atlantic Southeast Airlines,146,161,105,0,110,522
HSV,ORD,American Eagle Airlines Inc.,115,223,2274,0,3691,6303
HSV,TUS,Skywest Airlines Inc.,0,0,0,0,88,88
IAD,ABQ,United Air Lines Inc.,1041,374,908,0,648,2971
IAD,ATL,Atlantic Southeast Airlines,361,762,479,0,1063,2665
IAD,ATL,Delta Air Lines Inc.,2762,90,2876,0,3176,8904
IAD,BDL,United Air Lines Inc.,1136,156,420,0,2374,4086
IAD,BOS,JetBlue Airways,2351,28,2777,0,3389,8545
IAD,BOS,United Air Lines Inc.,2933,848,3711,57,3595,11144
IAD,BUR,JetBlue Airways,87,0,100,0,3,190
IAD,CLT,US Airways Inc.,1334,24,630,20,415,2423
IAD,DEN,United Air Lines Inc.,6493,1262,4617,39,5162,17573
IAD,DFW,American Airlines Inc.,4470,669,2484,41,5013,12677
IAD,FLL,JetBlue Airways,1267,39,996,17,3070,5389
IAD,FLL,United Air Lines Inc.,1031,292,535,0,1011,2869
IAD,JFK,JetBlue Airways,1585,58,4178,0,3567,9388
IAD,LAS,JetBlue Airways,339,68,344,0,482,1233
IAD,LAS,Southwest Airlines Co.,94,151,680,14,255,1194
IAD,LAS,United Air Lines Inc.,3319,564,2280,55,2449,8667
IAD,LAX,American Airlines Inc.,3549,748,3689,77,2479,10542
IAD,LAX,United Air Lines Inc.,7569,1347,5462,89,9386,23853
IAD,LGA,United Air Lines Inc.,399,16,2100,37,58,2610
IAD,LGB,JetBlue Airways,1110,22,539,0,1232,2903
IAD,MCO,JetBlue Airways,795,57,760,0,2009,3621
IAD,MCO,Southwest Airlines Co.,533,385,527,42,1846,3333
IAD,MCO,United Air Lines Inc.,6494,837,3467,43,7613,18454
IAD,MDW,Southwest Airlines Co.,1229,2228,3017,26,7822,14322
IAD,MIA,American Airlines Inc.,1334,0,200,46,0,1580
IAD,MIA,United Air Lines Inc.,378,172,237,25,853,1665
IAD,MSY,United Air Lines Inc.,2232,162,695,0,2275,5364
IAD,OAK,JetBlue Airways,840,55,718,6,2125,3744
IAD,OAK,United Air Lines Inc.,33,0,36,0,116,185
IAD,ORD,United Air Lines Inc.,5255,1395,7997,137,5496,20280
IAD,PDX,United Air Lines Inc.,630,340,597,0,1306,2873
IAD,PHX,US Airways Inc.,520,134,552,0,830,2036
IAD,PHX,United Air Lines Inc.,811,442,990,39,1697,3979
IAD,RDU,United Air Lines Inc.,1633,538,762,0,3302,6235
IAD,SAN,JetBlue Airways,335,0,629,5,1028,1997
IAD,SAN,United Air Lines Inc.,2237,612,1651,65,3437,8002
IAD,SEA,United Air Lines Inc.,2225,490,1028,48,2489,6280
IAD,SFO,United Air Lines Inc.,7961,1603,6270,118,6714,22666
IAD,SJC,United Air Lines Inc.,589,286,1069,0,1349,3293
IAD,SJU,American Airlines Inc.,811,108,158,0,260,1337
IAD,SJU,United Air Lines Inc.,1380,98,483,51,789,2801
IAD,SLC,Delta Air Lines Inc.,717,82,311,0,267,1377
IAD,SMF,United Air Lines Inc.,698,280,368,0,453,1799
IAD,STT,United Air Lines Inc.,775,28,169,70,149,1191
IAD,TPA,Southwest Airlines Co.,526,583,566,15,2724,4414
IAD,TPA,United Air Lines Inc.,3038,237,1025,63,2065,6428
IAD,TUS,United Air Lines Inc.,253,88,115,0,381,837
IAH,ATL,Atlantic Southeast Airlines,121,0,10,0,0,131
IAH,ATL,Delta Air Lines Inc.,1819,0,1585,0,1813,5217
IAH,ATL,Skywest Airlines Inc.,589,79,329,0,266,1263
IAH,CLT,US Airways Inc.,756,136,603,0,1490,2985
IAH,CVG,Atlantic Southeast Airlines,0,176,0,0,0,176
IAH,DEN,Frontier Airlines Inc.,1040,0,1008,0,1140,3188
IAH,DEN,Skywest Airlines Inc.,197,217,390,0,2229,3033
IAH,DEN,United Air Lines Inc.,1942,255,1827,0,4624,8648
IAH,DFW,American Airlines Inc.,2544,708,2061,0,10173,15486
IAH,MIA,American Airlines Inc.,1415,73,844,0,4387,6719
IAH,ORD,American Airlines Inc.,1826,49,5562,0,3370,10807
IAH,ORD,Skywest Airlines Inc.,128,94,5453,0,1225,6900
IAH,ORD,United Air Lines Inc.,916,0,1870,0,834,3620
IAH,PHX,US Airways Inc.,1893,164,417,0,1233,3707
IAH,SAT,Skywest Airlines Inc.,0,29,56,0,0,85
IAH,SFO,United Air Lines Inc.,2359,0,416,0,0,2775
IAH,SLC,Skywest Airlines Inc.,1259,29,695,0,2219,4202
ICT,ATL,Atlantic Southeast Airlines,6908,2369,2971,0,833,13081
ICT,DEN,Skywest Airlines Inc.,983,0,509,0,2414,3906
ICT,DEN,United Air Lines Inc.,3701,25,368,0,4020,8114
ICT,DFW,American Airlines Inc.,1595,1377,1013,0,2164,6149
ICT,DFW,American Eagle Airlines Inc.,121,347,216,0,868,1552
ICT,LAX,Skywest Airlines Inc.,173,0,10,0,344,527
ICT,ORD,American Eagle Airlines Inc.,1556,429,8777,0,7652,18414
ICT,ORD,Skywest Airlines Inc.,382,169,11215,0,1694,13460
ICT,ORD,United Air Lines Inc.,508,29,2041,0,582,3160
ICT,SLC,Skywest Airlines Inc.,0,0,0,0,44,44
IDA,DEN,Skywest Airlines Inc.,719,275,222,0,2052,3268
IDA,SLC,Skywest Airlines Inc.,1605,1245,356,0,2920,6126
ILM,ATL,Atlantic Southeast Airlines,6091,2087,3090,0,736,12004
ILM,CLT,US Airways Inc.,378,2,187,0,864,1431
ILM,CVG,Atlantic Southeast Airlines,98,0,0,0,0,98
IND,ATL,Atlantic Southeast Airlines,2722,1251,1512,0,1460,6945
IND,ATL,Delta Air Lines Inc.,1176,380,1210,0,1619,4385
IND,BWI,Southwest Airlines Co.,643,238,678,17,1736,3312
IND,CLT,US Airways Inc.,746,137,855,0,786,2524
IND,DCA,US Airways Inc.,0,0,0,0,273,273
IND,DEN,Frontier Airlines Inc.,1908,56,2076,0,1726,5766
IND,DEN,Southwest Airlines Co.,168,28,30,0,70,296
IND,DEN,United Air Lines Inc.,62,135,196,0,1183,1576
IND,DFW,American Airlines Inc.,3373,122,1848,0,5111,10454
IND,JAX,Southwest Airlines Co.,1332,0,209,11,2554,4106
IND,LAS,Southwest Airlines Co.,964,104,1425,17,2987,5497
IND,MCI,Southwest Airlines Co.,524,16,408,68,2559,3575
IND,MCO,Southwest Airlines Co.,362,117,264,36,1704,2483
IND,MDW,Southwest Airlines Co.,1082,772,1883,19,2051,5807
IND,MIA,American Eagle Airlines Inc.,748,15,352,30,1050,2195
IND,MKE,Skywest Airlines Inc.,697,278,379,0,346,1700
IND,ORD,American Airlines Inc.,98,21,2330,0,1812,4261
IND,ORD,American Eagle Airlines Inc.,3349,163,8009,0,15473,26994
IND,ORD,Skywest Airlines Inc.,853,652,11064,0,2684,15253
IND,ORD,United Air Lines Inc.,347,466,1836,0,1931,4580
IND,PHL,US Airways Inc.,0,0,0,0,147,147
IND,PHX,Southwest Airlines Co.,583,107,644,80,1425,2839
IND,PHX,US Airways Inc.,1412,15,281,0,236,1944
IND,TPA,Southwest Airlines Co.,320,32,191,0,933,1476
IPL,LAX,Skywest Airlines Inc.,717,184,66,68,675,1710
IPL,YUM,Skywest Airlines Inc.,654,106,129,26,778,1693
ISP,ATL,Atlantic Southeast Airlines,2635,227,369,5,294,3530
ISP,BWI,Southwest Airlines Co.,1749,660,1370,13,7062,10854
ISP,FLL,Southwest Airlines Co.,1616,94,565,7,2935,5217
ISP,LAS,Southwest Airlines Co.,270,108,211,23,0,612
ISP,MCO,Southwest Airlines Co.,1686,237,1197,64,4303,7487
ISP,MDW,Southwest Airlines Co.,1387,979,1630,14,3310,7320
ISP,PBI,Southwest Airlines Co.,964,328,412,63,2294,4061
ISP,RSW,Southwest Airlines Co.,407,51,161,0,8,627
ISP,TPA,Southwest Airlines Co.,1375,167,644,30,1453,3669
ITO,HNL,Hawaiian Airlines Inc.,1109,0,2,0,1972,3083
ITO,KOA,Hawaiian Airlines Inc.,54,0,0,0,36,90
ITO,OGG,Hawaiian Airlines Inc.,10,0,0,0,112,122
IYK,LAX,Skywest Airlines Inc.,1514,205,136,0,1002,2857
JAC,ATL,Delta Air Lines Inc.,141,27,218,0,250,636
JAC,CVG,Delta Air Lines Inc.,47,0,3,0,145,195
JAC,DEN,Frontier Airlines Inc.,0,0,48,0,42,90
JAC,DEN,United Air Lines Inc.,1921,300,648,0,4140,7009
JAC,DFW,American Airlines Inc.,779,79,469,0,0,1327
JAC,LAX,United Air Lines Inc.,28,0,38,0,274,340
JAC,ORD,American Airlines Inc.,81,759,1514,0,2582,4936
JAC,ORD,United Air Lines Inc.,448,71,987,0,2227,3733
JAC,SLC,Delta Air Lines Inc.,276,7,211,0,583,1077
JAC,SLC,Skywest Airlines Inc.,2704,1679,301,0,1802,6486
JAN,ATL,Atlantic Southeast Airlines,8273,1186,3586,0,844,13889
JAN,ATL,Delta Air Lines Inc.,1048,69,825,0,374,2316
JAN,BWI,Southwest Airlines Co.,716,451,332,0,1801,3300
JAN,CVG,Atlantic Southeast Airlines,165,0,9,0,0,174
JAN,DCA,Atlantic Southeast Airlines,45,0,4,0,0,49
JAN,DFW,American Eagle Airlines Inc.,2072,1319,1925,0,8846,14162
JAN,HOU,Southwest Airlines Co.,1335,297,456,31,4696,6815
JAN,MCO,Southwest Airlines Co.,192,0,81,0,1106,1379
JAN,MDW,Southwest Airlines Co.,716,344,484,0,1782,3326
JAN,ORD,American Eagle Airlines Inc.,404,443,1954,0,2629,5430
JAX,ATL,Delta Air Lines Inc.,3403,36,4821,0,4807,13067
JAX,BHM,Southwest Airlines Co.,3,0,15,0,837,855
JAX,BNA,Southwest Airlines Co.,806,29,223,20,5413,6491
JAX,BOS,JetBlue Airways,374,0,273,0,220,867
JAX,BWI,Southwest Airlines Co.,623,335,753,7,3837,5555
JAX,CLT,US Airways Inc.,932,203,382,0,1832,3349
JAX,CVG,Atlantic Southeast Airlines,113,0,0,0,0,113
JAX,DCA,US Airways Inc.,152,0,261,0,1855,2268
JAX,DEN,Frontier Airlines Inc.,446,0,162,0,211,819
JAX,DFW,American Airlines Inc.,2087,158,1037,0,3761,7043
JAX,FLL,Southwest Airlines Co.,698,121,888,18,8361,10086
JAX,HOU,Southwest Airlines Co.,362,9,219,0,1089,1679
JAX,IND,Southwest Airlines Co.,69,0,14,0,283,366
JAX,JFK,JetBlue Airways,1045,17,3293,0,2152,6507
JAX,LAX,Delta Air Lines Inc.,119,0,5,0,24,148
JAX,MIA,American Eagle Airlines Inc.,87,23,107,0,1015,1232
JAX,ORD,American Eagle Airlines Inc.,379,735,2329,0,5086,8529
JAX,ORD,United Air Lines Inc.,1132,24,4018,0,3491,8665
JAX,ORF,Southwest Airlines Co.,288,48,69,2,2898,3305
JAX,PHL,Southwest Airlines Co.,614,580,2637,0,2279,6110
JAX,PHL,US Airways Inc.,391,48,2150,0,674,3263
JAX,RDU,American Eagle Airlines Inc.,1716,50,252,0,4988,7006
JAX,TPA,Southwest Airlines Co.,186,250,287,0,2897,3620
JFK,ATL,Atlantic Southeast Airlines,355,725,150,0,0,1230
JFK,ATL,Delta Air Lines Inc.,4563,460,4443,0,2441,11907
JFK,AUS,JetBlue Airways,1683,32,1835,0,3932,7482
JFK,BNA,JetBlue Airways,30,0,24,0,0,54
JFK,BOS,American Eagle Airlines Inc.,3802,82,4555,0,7566,16005
JFK,BOS,Delta Air Lines Inc.,1453,0,1684,0,2784,5921
JFK,BOS,JetBlue Airways,3431,475,6249,0,6683,16838
JFK,BQN,JetBlue Airways,645,83,335,0,601,1664
JFK,BTV,JetBlue Airways,2251,14,1070,0,2470,5805
JFK,BUF,JetBlue Airways,3939,82,2054,21,4986,11082
JFK,BUR,JetBlue Airways,1159,0,1343,0,2237,4739
JFK,BWI,American Eagle Airlines Inc.,554,15,1018,0,1789,3376
JFK,CLE,American Eagle Airlines Inc.,1409,0,872,0,2112,4393
JFK,CLT,JetBlue Airways,2223,103,1501,0,2582,6409
JFK,CMH,JetBlue Airways,92,0,50,0,122,264
JFK,CVG,Delta Air Lines Inc.,1691,5,574,25,2070,4365
JFK,DCA,American Eagle Airlines Inc.,2951,214,2872,0,5959,11996
JFK,DEN,Delta Air Lines Inc.,709,0,399,0,603,1711
JFK,DEN,JetBlue Airways,830,1,1160,0,784,2775
JFK,DFW,American Airlines Inc.,3644,401,2054,37,2394,8530
JFK,FLL,Delta Air Lines Inc.,3453,212,2344,0,1588,7597
JFK,FLL,JetBlue Airways,5417,50,5845,13,11865,23190
JFK,HDN,Delta Air Lines Inc.,32,0,19,0,173,224
JFK,HOU,JetBlue Airways,1744,48,1496,0,3004,6292
JFK,IAD,JetBlue Airways,2366,0,1577,0,3269,7212
JFK,JAX,JetBlue Airways,2149,3,1591,5,3041,6789
JFK,LAS,American Airlines Inc.,2325,181,1406,0,919,4831
JFK,LAS,Delta Air Lines Inc.,2825,91,1708,0,1887,6511
JFK,LAS,JetBlue Airways,1510,186,2134,0,3457,7287
JFK,LAS,US Airways Inc.,1072,168,1586,0,4541,7367
JFK,LAX,American Airlines Inc.,16066,1505,9691,0,8207,35469
JFK,LAX,Delta Air Lines Inc.,4113,451,3418,0,2312,10294
JFK,LAX,United Air Lines Inc.,4228,359,4591,0,9725,18903
JFK,LGB,JetBlue Airways,1595,0,1530,0,1611,4736
JFK,MCO,American Airlines Inc.,1068,62,1015,0,1712,3857
JFK,MCO,Delta Air Lines Inc.,2555,249,1757,0,3013,7574
JFK,MCO,JetBlue Airways,4355,192,4419,47,8445,17458
JFK,MIA,American Airlines Inc.,15471,1894,6032,51,5996,29444
JFK,MIA,Delta Air Lines Inc.,2105,201,1293,0,3170,6769
JFK,MSY,JetBlue Airways,2375,13,1851,0,3155,7394
JFK,OAK,JetBlue Airways,701,4,1349,0,1269,3323
JFK,ONT,JetBlue Airways,177,0,758,0,1092,2027
JFK,ORD,American Airlines Inc.,2533,164,5073,45,2309,10124
JFK,ORD,American Eagle Airlines Inc.,196,2,2515,0,1651,4364
JFK,ORD,JetBlue Airways,3459,16,13290,0,5571,22336
JFK,PBI,JetBlue Airways,3676,198,4157,0,6464,14495
JFK,PDX,Delta Air Lines Inc.,706,75,932,0,598,2311
JFK,PDX,JetBlue Airways,294,0,96,0,718,1108
JFK,PHX,Delta Air Lines Inc.,1260,0,613,0,842,2715
JFK,PHX,JetBlue Airways,457,71,707,0,1576,2811
JFK,PHX,US Airways Inc.,1953,69,1251,34,2360,5667
JFK,PIT,American Eagle Airlines Inc.,423,10,1070,0,2599,4102
JFK,PIT,JetBlue Airways,1612,280,1380,0,3525,6797
JFK,PSE,JetBlue Airways,291,47,268,6,764,1376
JFK,PWM,JetBlue Airways,2000,294,1185,0,3961,7440
JFK,RDU,American Eagle Airlines Inc.,3155,191,2725,0,6463,12534
JFK,RDU,JetBlue Airways,2592,78,1415,0,4285,8370
JFK,RIC,JetBlue Airways,1655,28,936,9,2082,4710
JFK,ROC,JetBlue Airways,2145,376,2202,0,5048,9771
JFK,RSW,JetBlue Airways,2725,87,3111,0,5202,11125
JFK,SAN,American Airlines Inc.,1729,121,1027,0,1099,3976
JFK,SAN,Delta Air Lines Inc.,425,5,836,0,343,1609
JFK,SAN,JetBlue Airways,484,0,777,0,556,1817
JFK,SEA,American Airlines Inc.,2460,148,1518,0,1059,5185
JFK,SEA,Delta Air Lines Inc.,1265,87,1100,0,1160,3612
JFK,SEA,JetBlue Airways,545,44,282,0,364,1235
JFK,SFO,American Airlines Inc.,8325,500,7038,13,2957,18833
JFK,SFO,Delta Air Lines Inc.,3054,97,2803,0,1261,7215
JFK,SFO,JetBlue Airways,1032,2,3373,57,3583,8047
JFK,SFO,United Air Lines Inc.,4250,455,6441,0,8730,19876
JFK,SJC,JetBlue Airways,139,24,330,0,446,939
JFK,SJU,American Airlines Inc.,11676,204,2910,15,3446,18251
JFK,SJU,Delta Air Lines Inc.,630,28,223,0,150,1031
JFK,SJU,JetBlue Airways,1954,219,1240,48,703,4164
JFK,SLC,Delta Air Lines Inc.,2476,76,2422,0,2542,7516
JFK,SLC,JetBlue Airways,247,79,417,0,327,1070
JFK,SMF,JetBlue Airways,514,11,751,0,515,1791
JFK,SRQ,JetBlue Airways,780,0,314,0,445,1539
JFK,STL,American Eagle Airlines Inc.,1764,97,1390,0,1795,5046
JFK,STT,American Airlines Inc.,1939,0,233,0,37,2209
JFK,STT,Delta Air Lines Inc.,201,0,225,0,108,534
JFK,SYR,JetBlue Airways,2388,20,1833,0,2979,7220
JFK,TPA,American Airlines Inc.,677,48,325,0,496,1546
JFK,TPA,Delta Air Lines Inc.,2259,136,1553,0,3254,7202
JFK,TPA,JetBlue Airways,2850,71,3457,10,7169,13557
JFK,TUS,JetBlue Airways,534,7,355,0,390,1286
JNU,ANC,Alaska Airlines Inc.,2953,125,625,8,5914,9625
JNU,KTN,Alaska Airlines Inc.,157,149,84,0,347,737
JNU,PSG,Alaska Airlines Inc.,796,165,142,0,1097,2200
JNU,SEA,Alaska Airlines Inc.,1227,0,280,0,1877,3384
JNU,SIT,Alaska Airlines Inc.,1700,323,211,20,2195,4449
JNU,YAK,Alaska Airlines Inc.,1317,10,224,0,1711,3262
KOA,DEN,United Air Lines Inc.,283,0,33,0,0,316
KOA,HNL,Hawaiian Airlines Inc.,1687,0,0,0,1950,3637
KOA,LAX,American Airlines Inc.,2261,2,901,2,3797,6963
KOA,LAX,United Air Lines Inc.,1397,0,226,0,1445,3068
KOA,OGG,Hawaiian Airlines Inc.,15,0,0,0,181,196
KOA,ORD,United Air Lines Inc.,328,0,125,0,372,825
KOA,PHX,US Airways Inc.,681,0,133,0,0,814
KOA,SFO,United Air Lines Inc.,2936,0,787,0,3280,7003
KTN,JNU,Alaska Airlines Inc.,281,0,190,0,2342,2813
KTN,SEA,Alaska Airlines Inc.,684,167,324,0,3107,4282
KTN,SIT,Alaska Airlines Inc.,668,159,360,0,1574,2761
KTN,WRG,Alaska Airlines Inc.,415,393,208,0,841,1857
LAN,CVG,Atlantic Southeast Airlines,7,0,13,0,0,20
LAN,ORD,Skywest Airlines Inc.,316,134,8021,0,1591,10062
LAS,ABQ,Southwest Airlines Co.,1893,419,784,51,8241,11388
LAS,ALB,Southwest Airlines Co.,676,61,238,8,2876,3859
LAS,AMA,Southwest Airlines Co.,225,106,151,27,1183,1692
LAS,ANC,US Airways Inc.,512,12,443,0,321,1288
LAS,ATL,Delta Air Lines Inc.,2194,0,1362,0,5345,8901
LAS,ATL,US Airways Inc.,392,0,136,0,1392,1920
LAS,AUS,Southwest Airlines Co.,943,34,135,56,3683,4851
LAS,BDL,Southwest Airlines Co.,626,35,154,0,2191,3006
LAS,BHM,Southwest Airlines Co.,487,29,28,0,638,1182
LAS,BNA,Southwest Airlines Co.,1100,500,236,0,2610,4446
LAS,BOI,Southwest Airlines Co.,711,24,297,0,2142,3174
LAS,BOS,Delta Air Lines Inc.,204,0,70,0,429,703
LAS,BOS,JetBlue Airways,175,0,79,0,2271,2525
LAS,BOS,US Airways Inc.,1249,0,680,65,1657,3651
LAS,BUF,Southwest Airlines Co.,479,34,119,5,1484,2121
LAS,BUR,JetBlue Airways,0,0,9,0,63,72
LAS,BUR,Southwest Airlines Co.,5029,191,2329,99,16979,24627
LAS,BWI,Southwest Airlines Co.,1458,169,605,32,3821,6085
LAS,BWI,US Airways Inc.,714,0,94,0,1372,2180
LAS,CLE,Southwest Airlines Co.,722,0,190,8,800,1720
LAS,CLT,US Airways Inc.,4804,10,745,48,2416,8023
LAS,CMH,Southwest Airlines Co.,1154,147,271,13,2228,3813
LAS,CMH,US Airways Inc.,1803,0,206,0,1013,3022
LAS,CVG,Delta Air Lines Inc.,557,2,276,0,1848,2683
LAS,DCA,US Airways Inc.,683,0,251,0,1745,2679
LAS,DEN,Frontier Airlines Inc.,3467,129,3848,0,5301,12745
LAS,DEN,Southwest Airlines Co.,2322,341,539,32,6383,9617
LAS,DEN,United Air Lines Inc.,3494,155,1074,0,13735,18458
LAS,DFW,American Airlines Inc.,7610,444,3414,77,16896,28441
LAS,DFW,US Airways Inc.,1941,0,917,0,2157,5015
LAS,DTW,US Airways Inc.,1405,7,264,50,965,2691
LAS,ELP,Southwest Airlines Co.,1099,6,252,5,2879,4241
LAS,EWR,US Airways Inc.,500,0,73,0,527,1100
LAS,FAT,Skywest Airlines Inc.,2907,50,404,0,1948,5309
LAS,FAT,US Airways Inc.,281,0,61,0,223,565
LAS,FLL,Delta Air Lines Inc.,5,0,57,0,525,587
LAS,FLL,US Airways Inc.,1910,62,276,0,877,3125
LAS,GEG,Southwest Airlines Co.,833,35,810,29,3998,5705
LAS,HNL,Hawaiian Airlines Inc.,3380,0,31,0,928,4339
LAS,HOU,Southwest Airlines Co.,1737,57,317,26,3368,5505
LAS,IAD,JetBlue Airways,159,0,11,0,353,523
LAS,IAD,Southwest Airlines Co.,613,276,408,18,1713,3028
LAS,IAD,United Air Lines Inc.,1575,0,874,0,2214,4663
LAS,IND,Southwest Airlines Co.,1653,84,301,17,3223,5278
LAS,ISP,Southwest Airlines Co.,999,168,378,3,862,2410
LAS,JAX,Southwest Airlines Co.,116,29,48,9,704,906
LAS,JFK,American Airlines Inc.,1944,0,763,0,10,2717
LAS,JFK,Delta Air Lines Inc.,1771,0,927,0,2206,4904
LAS,JFK,JetBlue Airways,948,198,3382,0,3256,7784
LAS,JFK,US Airways Inc.,2630,0,3186,73,1007,6896
LAS,LAX,American Airlines Inc.,445,2,500,0,642,1589
LAS,LAX,American Eagle Airlines Inc.,440,0,1212,0,3807,5459
LAS,LAX,Southwest Airlines Co.,6504,605,4083,250,22001,33443
LAS,LAX,US Airways Inc.,2884,0,1400,32,5243,9559
LAS,LAX,United Air Lines Inc.,3419,35,1823,0,9263,14540
LAS,LBB,Southwest Airlines Co.,405,6,68,0,525,1004
LAS,LGB,JetBlue Airways,593,154,416,0,1789,2952
LAS,LIT,Southwest Airlines Co.,69,1,54,18,548,690
LAS,MAF,Southwest Airlines Co.,701,25,151,42,808,1727
LAS,MCI,Southwest Airlines Co.,1687,275,387,44,5572,7965
LAS,MCO,Delta Air Lines Inc.,58,0,57,0,741,856
LAS,MCO,Southwest Airlines Co.,549,94,165,3,1357,2168
LAS,MCO,US Airways Inc.,1351,0,284,0,926,2561
LAS,MDW,Southwest Airlines Co.,3318,710,1838,39,8591,14496
LAS,MHT,Southwest Airlines Co.,964,39,150,7,909,2069
LAS,MIA,American Airlines Inc.,1303,22,211,0,125,1661
LAS,MIA,US Airways Inc.,198,0,26,0,128,352
LAS,MSP,US Airways Inc.,936,0,294,0,1368,2598
LAS,MSY,Southwest Airlines Co.,824,36,96,25,2644,3625
LAS,OAK,Southwest Airlines Co.,5114,240,2298,94,16821,24567
LAS,OAK,US Airways Inc.,365,0,146,0,1453,1964
LAS,OKC,Southwest Airlines Co.,503,41,165,0,757,1466
LAS,OMA,Southwest Airlines Co.,895,34,315,2,2844,4090
LAS,ONT,Southwest Airlines Co.,3233,176,1213,80,12052,16754
LAS,ONT,US Airways Inc.,471,0,99,0,362,932
LAS,ORD,American Airlines Inc.,4200,51,9143,0,9195,22589
LAS,ORD,US Airways Inc.,2223,0,11274,0,2009,15506
LAS,ORD,United Air Lines Inc.,2689,64,4205,0,7422,14380
LAS,ORF,Southwest Airlines Co.,1448,104,179,1,1585,3317
LAS,PBI,US Airways Inc.,413,0,29,0,338,780
LAS,PDX,Alaska Airlines Inc.,2115,0,707,0,1863,4685
LAS,PDX,Southwest Airlines Co.,3373,180,1026,23,5108,9710
LAS,PDX,US Airways Inc.,1358,0,391,0,1766,3515
LAS,PHL,Southwest Airlines Co.,982,773,1281,7,1121,4164
LAS,PHL,US Airways Inc.,4726,27,1571,120,6950,13394
LAS,PHX,Southwest Airlines Co.,7207,1064,3514,128,17840,29753
LAS,PHX,US Airways Inc.,6551,3,1563,3,9180,17300
LAS,PIT,Southwest Airlines Co.,696,158,187,5,1944,2990
LAS,PIT,US Airways Inc.,874,3,312,0,585,1774
LAS,PSP,Skywest Airlines Inc.,1476,113,283,0,701,2573
LAS,PVD,Southwest Airlines Co.,434,235,211,0,1565,2445
LAS,RDU,Southwest Airlines Co.,840,89,284,7,2101,3321
LAS,RNO,Southwest Airlines Co.,5331,391,1918,51,18702,26393
LAS,RNO,US Airways Inc.,191,0,101,0,158,450
LAS,SAN,Southwest Airlines Co.,5698,466,2595,99,19493,28351
LAS,SAN,US Airways Inc.,1021,159,602,0,1185,2967
LAS,SAT,Southwest Airlines Co.,1959,38,219,4,3873,6093
LAS,SDF,Southwest Airlines Co.,1446,131,228,2,1971,3778
LAS,SEA,Alaska Airlines Inc.,4462,0,1891,12,8776,15141
LAS,SEA,Southwest Airlines Co.,1960,274,1154,10,4374,7772
LAS,SEA,US Airways Inc.,1443,0,402,0,1701,3546
LAS,SFO,Southwest Airlines Co.,3923,1959,9453,27,10558,25920
LAS,SFO,US Airways Inc.,1596,7,9946,0,3246,14795
LAS,SFO,United Air Lines Inc.,3535,355,7571,0,13157,24618
LAS,SJC,Southwest Airlines Co.,2802,143,1886,41,13928,18800
LAS,SJC,US Airways Inc.,975,3,285,0,1437,2700
LAS,SLC,Delta Air Lines Inc.,2656,0,458,0,2205,5319
LAS,SLC,JetBlue Airways,58,0,18,0,224,300
LAS,SLC,Skywest Airlines Inc.,263,95,185,0,1451,1994
LAS,SLC,Southwest Airlines Co.,3152,296,1433,57,11138,16076
LAS,SMF,Southwest Airlines Co.,3145,229,1663,40,12767,17844
LAS,SMF,US Airways Inc.,1683,0,146,8,1214,3051
LAS,SNA,Southwest Airlines Co.,1880,95,914,28,6841,9758
LAS,SNA,US Airways Inc.,2204,146,600,0,3059,6009
LAS,STL,American Airlines Inc.,521,11,185,0,3016,3733
LAS,STL,Southwest Airlines Co.,1584,280,364,40,4023,6291
LAS,TPA,Southwest Airlines Co.,775,159,74,2,1462,2472
LAS,TPA,US Airways Inc.,1322,0,110,0,1989,3421
LAS,TUL,Southwest Airlines Co.,361,0,106,0,683,1150
LAS,TUS,Southwest Airlines Co.,1654,300,444,76,7353,9827
LAW,ATL,Atlantic Southeast Airlines,898,456,124,0,32,1510
LAW,DFW,American Eagle Airlines Inc.,2697,2051,939,0,4764,10451
LAX,ABQ,Skywest Airlines Inc.,1557,0,30,0,1054,2641
LAX,ABQ,Southwest Airlines Co.,1448,0,209,2,5896,7555
LAX,ANC,Alaska Airlines Inc.,110,0,67,0,0,177
LAX,ASE,Skywest Airlines Inc.,1166,117,1,0,871,2155
LAX,ATL,Delta Air Lines Inc.,8057,15,2255,0,5596,15923
LAX,AUS,American Airlines Inc.,1300,4,275,0,1811,3390
LAX,AUS,Skywest Airlines Inc.,544,0,0,0,248,792
LAX,AUS,Southwest Airlines Co.,140,0,16,0,340,496
LAX,BDL,Delta Air Lines Inc.,172,0,89,0,260,521
LAX,BFL,Skywest Airlines Inc.,2489,388,86,0,1339,4302
LAX,BNA,American Airlines Inc.,960,0,195,0,873,2028
LAX,BNA,Southwest Airlines Co.,1203,8,309,29,2621,4170
LAX,BOI,Skywest Airlines Inc.,951,16,102,0,618,1687
LAX,BOS,American Airlines Inc.,4654,15,1762,0,3060,9491
LAX,BOS,Delta Air Lines Inc.,1026,69,394,0,556,2045
LAX,BOS,United Air Lines Inc.,2242,12,809,0,1826,4889
LAX,BWI,United Air Lines Inc.,1410,40,538,0,2433,4421
LAX,CLD,Skywest Airlines Inc.,3506,179,428,0,1472,5585
LAX,CLT,US Airways Inc.,2699,0,445,0,1322,4466
LAX,CMH,Delta Air Lines Inc.,65,0,35,0,149,249
LAX,COS,Skywest Airlines Inc.,2334,0,43,0,1447,3824
LAX,CVG,Delta Air Lines Inc.,1089,14,197,0,1324,2624
LAX,DCA,Alaska Airlines Inc.,292,0,274,17,455,1038
LAX,DEN,American Airlines Inc.,1934,28,407,0,5105,7474
LAX,DEN,Frontier Airlines Inc.,1849,57,2759,0,3848,8513
LAX,DEN,Southwest Airlines Co.,739,0,388,0,2356,3483
LAX,DEN,United Air Lines Inc.,5674,222,1351,0,15543,22790
LAX,DFW,American Airlines Inc.,15639,398,3316,61,11006,30420
LAX,DFW,Skywest Airlines Inc.,1655,29,457,0,271,2412
LAX,DSM,Skywest Airlines Inc.,388,0,46,0,91,525
LAX,EGE,American Airlines Inc.,1201,436,284,0,1786,3707
LAX,ELP,Southwest Airlines Co.,480,16,66,4,2686,3252
LAX,EWR,American Airlines Inc.,2620,0,4311,0,1051,7982
LAX,EWR,United Air Lines Inc.,826,151,86,0,784,1847
LAX,FAT,American Eagle Airlines Inc.,1736,81,344,0,997,3158
LAX,FAT,Skywest Airlines Inc.,4600,408,568,82,3330,8988
LAX,FLL,American Airlines Inc.,1147,17,485,0,932,2581
LAX,FLL,Delta Air Lines Inc.,147,0,78,0,34,259
LAX,HNL,American Airlines Inc.,7712,34,1068,0,5655,14469
LAX,HNL,Delta Air Lines Inc.,2249,0,235,0,1974,4458
LAX,HNL,Hawaiian Airlines Inc.,3737,21,0,0,948,4706
LAX,HNL,United Air Lines Inc.,4029,112,293,0,5708,10142
LAX,HOU,Southwest Airlines Co.,1166,12,471,31,4298,5978
LAX,IAD,American Airlines Inc.,3785,46,737,38,2454,7060
LAX,IAD,United Air Lines Inc.,7174,208,1616,0,8776,17774
LAX,ICT,Skywest Airlines Inc.,737,0,63,0,715,1515
LAX,IPL,Skywest Airlines Inc.,1218,103,225,0,595,2141
LAX,IYK,Skywest Airlines Inc.,1152,90,33,0,162,1437
LAX,JAC,United Air Lines Inc.,6,0,0,0,14,20
LAX,JAX,Delta Air Lines Inc.,7,0,0,0,8,15
LAX,JFK,American Airlines Inc.,9568,23,11120,12,5797,26520
LAX,JFK,Delta Air Lines Inc.,1978,166,2261,45,2101,6551
LAX,JFK,United Air Lines Inc.,3689,370,8242,0,4861,17162
LAX,KOA,American Airlines Inc.,2108,147,486,0,2626,5367
LAX,KOA,Delta Air Lines Inc.,17,0,15,0,0,32
LAX,KOA,United Air Lines Inc.,481,0,94,0,1334,1909
LAX,LAS,American Airlines Inc.,737,0,643,0,1206,2586
LAX,LAS,American Eagle Airlines Inc.,1689,78,1128,0,683,3578
LAX,LAS,Southwest Airlines Co.,4433,1113,4852,25,17645,28068
LAX,LAS,US Airways Inc.,1765,8,1683,22,3486,6964
LAX,LAS,United Air Lines Inc.,5248,127,1966,0,5599,12940
LAX,LIH,American Airlines Inc.,2079,0,237,0,894,3210
LAX,LIH,Delta Air Lines Inc.,322,0,45,0,0,367
LAX,LIH,United Air Lines Inc.,928,0,160,0,850,1938
LAX,MCI,Southwest Airlines Co.,1296,117,345,0,3180,4938
LAX,MCO,American Airlines Inc.,327,0,156,0,167,650
LAX,MCO,Delta Air Lines Inc.,422,7,139,0,1016,1584
LAX,MCO,United Air Lines Inc.,1864,67,382,0,2398,4711
LAX,MDW,Southwest Airlines Co.,2335,385,1357,91,5428,9596
LAX,MIA,American Airlines Inc.,7032,37,1905,11,3882,12867
LAX,MOD,Skywest Airlines Inc.,2441,421,123,0,615,3600
LAX,MRY,American Eagle Airlines Inc.,1822,314,281,0,688,3105
LAX,MRY,Skywest Airlines Inc.,5305,220,211,0,1503,7239
LAX,MSY,Delta Air Lines Inc.,236,0,87,0,613,936
LAX,MSY,United Air Lines Inc.,1059,0,168,0,3236,4463
LAX,MTJ,Skywest Airlines Inc.,213,0,0,0,0,213
LAX,OAK,Skywest Airlines Inc.,3102,41,342,15,2314,5814
LAX,OAK,Southwest Airlines Co.,5104,14,2629,142,22354,30243
LAX,OGG,American Airlines Inc.,4983,0,534,0,956,6473
LAX,OGG,Delta Air Lines Inc.,966,0,69,0,1443,2478
LAX,OGG,United Air Lines Inc.,3128,18,262,0,2995,6403
LAX,OKC,Skywest Airlines Inc.,626,135,50,0,686,1497
LAX,ONT,Skywest Airlines Inc.,262,0,0,0,127,389
LAX,ORD,American Airlines Inc.,8428,162,15708,0,8940,33238
LAX,ORD,United Air Lines Inc.,9342,139,9566,0,11696,30743
LAX,OXR,Skywest Airlines Inc.,2275,147,114,62,1314,3912
LAX,PDX,Alaska Airlines Inc.,1338,0,620,127,1989,4074
LAX,PDX,Skywest Airlines Inc.,3054,0,628,126,2108,5916
LAX,PDX,United Air Lines Inc.,489,0,146,0,1566,2201
LAX,PHL,US Airways Inc.,2195,0,867,0,1482,4544
LAX,PHL,United Air Lines Inc.,1311,75,1610,0,1224,4220
LAX,PHX,Skywest Airlines Inc.,3468,45,943,0,1545,6001
LAX,PHX,Southwest Airlines Co.,4577,86,2433,85,15544,22725
LAX,PHX,US Airways Inc.,1772,0,693,47,4381,6893
LAX,PHX,United Air Lines Inc.,0,0,0,0,38,38
LAX,PIT,US Airways Inc.,327,0,44,0,693,1064
LAX,PSP,Skywest Airlines Inc.,6121,347,674,0,2305,9447
LAX,RDU,Delta Air Lines Inc.,42,128,22,0,47,239
LAX,RNO,Skywest Airlines Inc.,662,0,0,0,660,1322
LAX,RNO,Southwest Airlines Co.,1434,62,478,7,3352,5333
LAX,SAN,American Eagle Airlines Inc.,4562,165,1363,0,2749,8839
LAX,SAN,Skywest Airlines Inc.,12325,1170,979,0,2280,16754
LAX,SAT,American Airlines Inc.,1681,0,167,0,1304,3152
LAX,SAT,Skywest Airlines Inc.,1780,82,96,0,1040,2998
LAX,SAT,Southwest Airlines Co.,279,0,37,0,2082,2398
LAX,SBA,American Eagle Airlines Inc.,1840,238,379,0,1374,3831
LAX,SBA,Skywest Airlines Inc.,5157,457,419,0,1901,7934
LAX,SBP,American Eagle Airlines Inc.,2660,194,369,0,930,4153
LAX,SBP,Skywest Airlines Inc.,3364,75,186,0,1545,5170
LAX,SEA,Alaska Airlines Inc.,6388,0,2663,171,5151,14373
LAX,SEA,Skywest Airlines Inc.,406,0,36,0,104,546
LAX,SEA,United Air Lines Inc.,2288,23,1001,0,5466,8778
LAX,SFO,Alaska Airlines Inc.,378,0,1544,96,453,2471
LAX,SFO,American Airlines Inc.,3251,93,11582,0,8826,23752
LAX,SFO,Southwest Airlines Co.,3228,3140,12435,0,12095,30898
LAX,SFO,United Air Lines Inc.,7834,397,21905,0,26051,56187
LAX,SGU,Skywest Airlines Inc.,1527,0,55,0,1106,2688
LAX,SJC,American Eagle Airlines Inc.,2196,22,598,0,1368,4184
LAX,SJC,Skywest Airlines Inc.,3804,27,479,0,2536,6846
LAX,SJC,Southwest Airlines Co.,2986,28,2334,90,19285,24723
LAX,SJU,American Airlines Inc.,526,68,27,0,177,798
LAX,SLC,Delta Air Lines Inc.,3093,0,1192,0,2448,6733
LAX,SLC,Skywest Airlines Inc.,3214,113,1122,33,3236,7718
LAX,SLC,Southwest Airlines Co.,1616,50,681,14,5093,7454
LAX,SMF,Skywest Airlines Inc.,3043,78,412,0,1639,5172
LAX,SMF,Southwest Airlines Co.,3331,26,1432,63,12885,17737
LAX,SMX,Skywest Airlines Inc.,3313,292,257,0,1864,5726
LAX,SNA,Skywest Airlines Inc.,300,106,0,0,129,535
LAX,STL,American Airlines Inc.,2109,19,415,0,3338,5881
LAX,STL,Southwest Airlines Co.,368,0,50,0,932,1350
LAX,TPA,Delta Air Lines Inc.,711,0,159,0,915,1785
LAX,TUL,Skywest Airlines Inc.,15,0,0,0,0,15
LAX,TUS,Skywest Airlines Inc.,3726,20,457,0,2646,6849
LAX,TUS,Southwest Airlines Co.,1181,0,441,66,7841,9529
LAX,XNA,American Eagle Airlines Inc.,1441,0,91,0,1974,3506
LAX,YUM,Skywest Airlines Inc.,1635,311,88,24,361,2419
LBB,ABQ,Southwest Airlines Co.,288,92,145,0,2464,2989
LBB,AUS,Southwest Airlines Co.,516,505,47,0,1046,2114
LBB,DAL,Southwest Airlines Co.,1879,1562,829,0,9461,13731
LBB,DFW,American Eagle Airlines Inc.,5306,3298,2145,4,12786,23539
LBB,ELP,Southwest Airlines Co.,196,0,41,0,472,709
LBB,LAS,Southwest Airlines Co.,223,0,245,0,1408,1876
LEX,ATL,Atlantic Southeast Airlines,3324,1584,1480,0,649,7037
LEX,ATL,Delta Air Lines Inc.,573,166,469,0,0,1208
LEX,CVG,Atlantic Southeast Airlines,43,20,0,0,0,63
LEX,DFW,American Eagle Airlines Inc.,1761,67,730,0,3186,5744
LEX,ORD,American Eagle Airlines Inc.,709,112,2106,0,2250,5177
LEX,ORD,Skywest Airlines Inc.,613,224,14953,0,1211,17001
LFT,ATL,Atlantic Southeast Airlines,3127,1145,1471,0,155,5898
LFT,DFW,American Eagle Airlines Inc.,3360,1782,1158,0,4197,10497
LGA,ATL,American Airlines Inc.,2419,264,1792,0,5162,9637
LGA,ATL,Delta Air Lines Inc.,4896,450,7283,0,12939,25568
LGA,BNA,American Airlines Inc.,2064,335,1816,0,4449,8664
LGA,BOS,American Eagle Airlines Inc.,4061,431,4345,0,11585,20422
LGA,BOS,Delta Air Lines Inc.,1231,455,1968,0,2528,6182
LGA,BOS,US Airways Inc.,930,204,1806,0,6985,9925
LGA,CAE,Atlantic Southeast Airlines,902,4500,1716,0,1040,8158
LGA,CLE,American Eagle Airlines Inc.,2967,444,2649,0,5875,11935
LGA,CLT,American Eagle Airlines Inc.,3130,167,3665,0,6340,13302
LGA,CLT,US Airways Inc.,1550,137,2261,0,7022,10970
LGA,CMH,American Eagle Airlines Inc.,3341,706,2574,0,9670,16291
LGA,CVG,American Eagle Airlines Inc.,1193,214,2051,0,3194,6652
LGA,CVG,Delta Air Lines Inc.,1874,120,1068,0,2028,5090
LGA,DCA,American Eagle Airlines Inc.,4306,660,2538,0,7532,15036
LGA,DCA,Delta Air Lines Inc.,1479,380,1707,0,1970,5536
LGA,DCA,US Airways Inc.,540,509,2030,0,7333,10412
LGA,DEN,Frontier Airlines Inc.,2587,520,4138,131,3486,10862
LGA,DEN,United Air Lines Inc.,3046,1054,3452,0,11764,19316
LGA,DFW,American Airlines Inc.,7634,2032,10808,0,21731,42205
LGA,DSM,American Eagle Airlines Inc.,1049,3,554,0,1467,3073
LGA,DTW,American Eagle Airlines Inc.,2901,1150,2436,0,6973,13460
LGA,EGE,American Airlines Inc.,66,30,73,0,77,246
LGA,FLL,American Airlines Inc.,433,202,249,0,560,1444
LGA,FLL,Delta Air Lines Inc.,3564,431,1827,0,4111,9933
LGA,FLL,JetBlue Airways,2206,44,2910,11,14794,19965
LGA,FNT,American Eagle Airlines Inc.,216,104,133,0,1461,1914
LGA,HDN,Delta Air Lines Inc.,233,0,38,0,0,271
LGA,IAD,United Air Lines Inc.,341,211,317,0,3224,4093
LGA,MCO,American Airlines Inc.,1637,172,1685,0,5763,9257
LGA,MCO,Delta Air Lines Inc.,1426,54,1506,0,5338,8324
LGA,MCO,JetBlue Airways,459,0,557,0,3504,4520
LGA,MEM,American Eagle Airlines Inc.,1584,161,1822,0,3941,7508
LGA,MIA,American Airlines Inc.,6246,1576,6559,0,19726,34107
LGA,MSN,American Eagle Airlines Inc.,496,25,451,0,852,1824
LGA,MSP,American Airlines Inc.,610,127,478,0,1901,3116
LGA,MSY,American Airlines Inc.,536,18,234,0,22,810
LGA,MSY,Delta Air Lines Inc.,257,127,256,0,502,1142
LGA,ORD,American Airlines Inc.,6620,1305,32455,0,29660,70040
LGA,ORD,United Air Lines Inc.,4988,1482,23845,0,33836,64151
LGA,PBI,American Airlines Inc.,296,27,187,10,0,520
LGA,PBI,Delta Air Lines Inc.,1386,164,1862,0,5802,9214
LGA,PBI,JetBlue Airways,871,47,1183,0,5018,7119
LGA,PIT,American Eagle Airlines Inc.,1137,81,782,0,1692,3692
LGA,PIT,US Airways Inc.,201,220,467,0,1629,2517
LGA,RDU,American Airlines Inc.,621,185,826,0,2306,3938
LGA,RDU,American Eagle Airlines Inc.,4904,215,2787,0,9183,17089
LGA,RSW,Delta Air Lines Inc.,675,0,241,0,339,1255
LGA,SDF,American Eagle Airlines Inc.,1732,329,1567,0,4087,7715
LGA,SRQ,Atlantic Southeast Airlines,941,1010,726,0,221,2898
LGA,STL,American Airlines Inc.,1755,164,1465,0,5461,8845
LGA,STT,US Airways Inc.,113,0,17,0,0,130
LGA,TPA,American Airlines Inc.,797,64,780,0,2404,4045
LGA,TPA,Delta Air Lines Inc.,818,109,633,0,3250,4810
LGA,TVC,American Eagle Airlines Inc.,0,0,8,0,9,17
LGA,XNA,American Eagle Airlines Inc.,1024,446,1200,0,3514,6184
LGB,AUS,JetBlue Airways,575,0,0,0,169,744
LGB,BOS,JetBlue Airways,761,0,213,0,700,1674
LGB,FLL,JetBlue Airways,276,0,50,0,481,807
LGB,IAD,JetBlue Airways,539,0,113,0,1132,1784
LGB,JFK,JetBlue Airways,694,5,2591,0,1824,5114
LGB,LAS,JetBlue Airways,392,0,1300,0,1106,2798
LGB,OAK,JetBlue Airways,1269,1,443,0,2189,3902
LGB,ORD,JetBlue Airways,467,0,5774,0,1894,8135
LGB,SEA,Alaska Airlines Inc.,1246,68,189,48,1141,2692
LGB,SEA,JetBlue Airways,19,0,35,0,46,100
LGB,SJC,JetBlue Airways,11,0,58,0,21,90
LGB,SLC,JetBlue Airways,1172,0,329,0,1229,2730
LGB,SLC,Skywest Airlines Inc.,744,146,40,0,2144,3074
LGB,SMF,JetBlue Airways,949,0,295,0,1025,2269
LIH,DEN,United Air Lines Inc.,109,0,31,0,0,140
LIH,HNL,Hawaiian Airlines Inc.,863,0,0,0,3799,4662
LIH,LAX,American Airlines Inc.,267,0,522,0,2182,2971
LIH,LAX,Delta Air Lines Inc.,13,0,0,0,57,70
LIH,LAX,United Air Lines Inc.,524,0,190,0,650,1364
LIH,OGG,Hawaiian Airlines Inc.,159,0,0,0,152,311
LIH,PHX,US Airways Inc.,774,0,104,0,142,1020
LIH,SEA,Alaska Airlines Inc.,273,0,41,0,23,337
LIH,SFO,United Air Lines Inc.,862,0,134,0,735,1731
LIT,ATL,Atlantic Southeast Airlines,9800,3137,3027,0,807,16771
LIT,ATL,Delta Air Lines Inc.,1974,255,330,0,488,3047
LIT,BWI,Southwest Airlines Co.,162,79,475,0,2680,3396
LIT,CVG,Atlantic Southeast Airlines,0,39,1,0,0,40
LIT,DAL,Southwest Airlines Co.,1714,1414,1184,0,11672,15984
LIT,DFW,American Eagle Airlines Inc.,6472,1812,2905,20,15625,26834
LIT,HOU,Southwest Airlines Co.,232,246,250,0,357,1085
LIT,LAS,Southwest Airlines Co.,99,12,374,0,1176,1661
LIT,MDW,Southwest Airlines Co.,329,192,96,0,709,1326
LIT,ORD,American Eagle Airlines Inc.,2769,472,5917,0,6598,15756
LIT,ORD,Skywest Airlines Inc.,0,57,0,0,0,57
LIT,PHX,Southwest Airlines Co.,244,16,68,0,0,328
LIT,SLC,Skywest Airlines Inc.,0,190,176,0,89,455
LIT,STL,Southwest Airlines Co.,524,39,214,0,2215,2992
LNK,DEN,Skywest Airlines Inc.,1043,96,544,89,5421,7193
LNK,ORD,Skywest Airlines Inc.,569,137,15003,0,2027,17736
LNK,PIA,Skywest Airlines Inc.,0,100,0,0,0,100
LRD,DFW,American Eagle Airlines Inc.,2483,346,1723,0,4902,9454
LSE,ORD,American Eagle Airlines Inc.,2033,40,4751,0,5813,12637
LWB,ATL,Atlantic Southeast Airlines,684,13,194,0,87,978
LWS,SLC,Skywest Airlines Inc.,179,18,25,0,493,715
LYH,ATL,Atlantic Southeast Airlines,1092,280,620,0,68,2060
MAF,ABQ,Southwest Airlines Co.,314,0,35,0,433,782
MAF,AUS,Southwest Airlines Co.,217,9,72,0,1903,2201
MAF,DAL,Southwest Airlines Co.,1183,925,732,2,9706,12548
MAF,DFW,American Eagle Airlines Inc.,1771,1286,1769,0,7817,12643
MAF,HOU,Southwest Airlines Co.,321,499,519,7,2744,4090
MAF,LAS,Southwest Airlines Co.,107,114,350,0,1786,2357
MBS,ORD,Skywest Airlines Inc.,84,0,3392,0,1454,4930
MCI,ABQ,Southwest Airlines Co.,904,309,258,0,2523,3994
MCI,ATL,Atlantic Southeast Airlines,858,157,369,0,322,1706
MCI,ATL,Delta Air Lines Inc.,1769,81,1838,0,2925,6613
MCI,AUS,Skywest Airlines Inc.,2531,156,76,0,755,3518
MCI,BNA,Southwest Airlines Co.,1379,114,630,0,4614,6737
MCI,BWI,Southwest Airlines Co.,915,161,381,8,1423,2888
MCI,CLT,US Airways Inc.,451,0,112,0,195,758
MCI,CMH,Skywest Airlines Inc.,715,0,0,0,0,715
MCI,COS,Skywest Airlines Inc.,1683,250,10,0,0,1943
MCI,DAL,American Eagle Airlines Inc.,1295,1073,2448,0,9670,14486
MCI,DAL,Southwest Airlines Co.,2735,652,2182,13,12730,18312
MCI,DEN,Frontier Airlines Inc.,1596,33,2076,0,2032,5737
MCI,DEN,Skywest Airlines Inc.,409,81,209,0,550,1249
MCI,DEN,Southwest Airlines Co.,1483,41,638,0,4459,6621
MCI,DEN,United Air Lines Inc.,4001,49,1552,0,8213,13815
MCI,DFW,American Airlines Inc.,2212,870,3108,0,8161,14351
MCI,EWR,Skywest Airlines Inc.,0,0,118,0,0,118
MCI,IND,Southwest Airlines Co.,1308,0,279,0,2395,3982
MCI,LAS,Southwest Airlines Co.,1537,1196,2110,0,5149,9992
MCI,LAX,Southwest Airlines Co.,1563,27,1068,19,3566,6243
MCI,LNK,Skywest Airlines Inc.,0,70,38,0,0,108
MCI,MCO,Southwest Airlines Co.,1025,397,241,0,1425,3088
MCI,MDW,Southwest Airlines Co.,2948,2664,4394,5,17929,27940
MCI,MKE,Skywest Airlines Inc.,23,0,0,0,0,23
MCI,MSN,Skywest Airlines Inc.,1500,391,14,0,469,2374
MCI,OAK,Southwest Airlines Co.,615,70,860,3,2419,3967
MCI,OKC,Southwest Airlines Co.,1228,20,540,0,6228,8016
MCI,ORD,American Airlines Inc.,1607,172,8522,0,9558,19859
MCI,ORD,Skywest Airlines Inc.,0,0,2215,0,115,2330
MCI,ORD,United Air Lines Inc.,994,154,6701,0,5683,13532
MCI,PDX,Southwest Airlines Co.,446,4,385,0,2145,2980
MCI,PHX,Southwest Airlines Co.,1805,148,1047,12,4119,7131
MCI,PHX,US Airways Inc.,754,60,298,6,1219,2337
MCI,PIT,Skywest Airlines Inc.,1622,626,123,0,607,2978
MCI,RDU,American Eagle Airlines Inc.,77,70,263,0,2986,3396
MCI,SAN,Southwest Airlines Co.,748,432,416,0,1383,2979
MCI,SAT,Skywest Airlines Inc.,6458,688,291,0,499,7936
MCI,SEA,Southwest Airlines Co.,395,0,195,5,1087,1682
MCI,SLC,Skywest Airlines Inc.,114,386,604,0,515,1619
MCI,SMF,Southwest Airlines Co.,995,37,170,0,1030,2232
MCI,STL,Southwest Airlines Co.,1406,489,792,6,4680,7373
MCI,TPA,Southwest Airlines Co.,1692,116,137,0,1324,3269
MCI,TUL,Southwest Airlines Co.,981,12,368,0,5446,6807
MCN,ATL,Atlantic Southeast Airlines,2930,902,1047,39,0,4918
MCO,ABQ,Southwest Airlines Co.,485,419,390,64,970,2328
MCO,ALB,Southwest Airlines Co.,995,219,395,6,2296,3911
MCO,ATL,Delta Air Lines Inc.,5000,461,7639,30,6578,19708
MCO,AUS,JetBlue Airways,4,0,3,0,72,79
MCO,AUS,Southwest Airlines Co.,412,33,112,0,665,1222
MCO,AVL,Atlantic Southeast Airlines,326,0,12,0,0,338
MCO,BDL,Delta Air Lines Inc.,885,87,361,0,2355,3688
MCO,BDL,Southwest Airlines Co.,1606,398,684,107,2012,4807
MCO,BHM,Southwest Airlines Co.,1263,163,408,50,3130,5014
MCO,BNA,Southwest Airlines Co.,1568,151,635,159,5586,8099
MCO,BOS,Delta Air Lines Inc.,1696,46,1458,0,3737,6937
MCO,BOS,JetBlue Airways,3418,0,3432,21,4419,11290
MCO,BQN,JetBlue Airways,347,5,248,0,2979,3579
MCO,BTV,JetBlue Airways,427,45,147,0,439,1058
MCO,BUF,JetBlue Airways,784,24,240,0,1115,2163
MCO,BUF,Southwest Airlines Co.,1060,142,463,32,2210,3907
MCO,BWI,Southwest Airlines Co.,3140,1759,2394,84,8753,16130
MCO,BWI,US Airways Inc.,13,0,158,0,206,377
MCO,CLE,Southwest Airlines Co.,522,63,240,15,2155,2995
MCO,CLT,US Airways Inc.,2641,774,1743,7,7822,12987
MCO,CMH,Southwest Airlines Co.,2286,379,483,63,2628,5839
MCO,CVG,Delta Air Lines Inc.,892,176,559,0,1251,2878
MCO,DCA,US Airways Inc.,776,374,1580,0,2259,4989
MCO,DEN,Frontier Airlines Inc.,944,183,1740,0,986,3853
MCO,DEN,Southwest Airlines Co.,926,152,924,24,1062,3088
MCO,DEN,United Air Lines Inc.,3255,289,1516,0,4934,9994
MCO,DFW,American Airlines Inc.,5419,2057,4070,0,15091,26637
MCO,DTW,Southwest Airlines Co.,1014,109,371,31,1982,3507
MCO,EWR,JetBlue Airways,1395,4,12655,0,7400,21454
MCO,EYW,Atlantic Southeast Airlines,63,0,56,0,0,119
MCO,FLL,Southwest Airlines Co.,2700,900,843,8,5881,10332
MCO,HOU,Southwest Airlines Co.,2073,477,742,59,5783,9134
MCO,HPN,JetBlue Airways,752,0,689,15,2804,4260
MCO,HSV,Atlantic Southeast Airlines,218,121,117,0,0,456
MCO,IAD,JetBlue Airways,1294,0,386,0,2971,4651
MCO,IAD,Southwest Airlines Co.,1256,700,818,9,895,3678
MCO,IAD,United Air Lines Inc.,2562,363,1726,0,5436,10087
MCO,IND,Southwest Airlines Co.,1393,126,292,0,2073,3884
MCO,ISP,Southwest Airlines Co.,2198,400,1736,34,4979,9347
MCO,JAN,Southwest Airlines Co.,694,135,266,4,1217,2316
MCO,JFK,American Airlines Inc.,78,40,1228,0,906,2252
MCO,JFK,Delta Air Lines Inc.,1448,233,3154,0,3746,8581
MCO,JFK,JetBlue Airways,4915,122,11188,67,8568,24860
MCO,LAS,Delta Air Lines Inc.,203,1,451,0,563,1218
MCO,LAS,Southwest Airlines Co.,372,30,167,16,346,931
MCO,LAS,US Airways Inc.,986,32,245,0,1177,2440
MCO,LAX,American Airlines Inc.,1423,139,514,0,1776,3852
MCO,LAX,Delta Air Lines Inc.,1289,63,472,0,947,2771
MCO,LAX,United Air Lines Inc.,1085,100,952,0,3276,5413
MCO,LGA,American Airlines Inc.,1657,146,3189,0,3278,8270
MCO,LGA,Delta Air Lines Inc.,1583,65,4876,0,3564,10088
MCO,LGA,JetBlue Airways,843,3,5907,0,1213,7966
MCO,MCI,Southwest Airlines Co.,996,531,511,40,1655,3733
MCO,MDW,Southwest Airlines Co.,3551,758,2033,57,5639,12038
MCO,MEM,Frontier Airlines Inc.,30,0,43,0,6,79
MCO,MHT,Southwest Airlines Co.,1393,226,702,35,6379,8735
MCO,MIA,American Airlines Inc.,8295,560,2110,0,13427,24392
MCO,MSY,Atlantic Southeast Airlines,72,0,34,0,23,129
MCO,MSY,Southwest Airlines Co.,1051,131,387,118,4068,5755
MCO,OMA,Southwest Airlines Co.,13,0,0,0,110,123
MCO,ORD,American Airlines Inc.,1395,211,12355,0,6313,20274
MCO,ORD,United Air Lines Inc.,2547,491,7985,0,9561,20584
MCO,ORF,Southwest Airlines Co.,683,79,306,0,2133,3201
MCO,PDX,Alaska Airlines Inc.,1103,0,372,0,380,1855
MCO,PFN,Atlantic Southeast Airlines,128,156,145,0,22,451
MCO,PHL,Southwest Airlines Co.,2433,2371,7745,16,4753,17318
MCO,PHL,US Airways Inc.,1835,357,5567,10,8246,16015
MCO,PHX,Southwest Airlines Co.,911,178,542,11,863,2505
MCO,PHX,US Airways Inc.,542,269,519,10,533,1873
MCO,PIT,Southwest Airlines Co.,1024,257,338,38,2897,4554
MCO,PIT,US Airways Inc.,421,201,508,1,1487,2618
MCO,PNS,Atlantic Southeast Airlines,711,164,14,0,0,889
MCO,PSE,JetBlue Airways,309,57,87,0,1264,1717
MCO,PVD,Southwest Airlines Co.,1883,217,1330,47,5179,8656
MCO,PVD,US Airways Inc.,10,0,0,0,163,173
MCO,PWM,JetBlue Airways,324,0,96,0,869,1289
MCO,RDU,Atlantic Southeast Airlines,368,527,24,5,6,930
MCO,RDU,Southwest Airlines Co.,1602,437,449,17,3201,5706
MCO,RIC,Atlantic Southeast Airlines,264,158,90,0,50,562
MCO,ROC,JetBlue Airways,273,0,130,0,779,1182
MCO,RSW,Southwest Airlines Co.,2366,228,651,18,4706,7969
MCO,SAT,Southwest Airlines Co.,352,140,79,68,825,1464
MCO,SDF,Atlantic Southeast Airlines,69,195,8,0,25,297
MCO,SDF,Southwest Airlines Co.,621,651,152,5,1444,2873
MCO,SEA,Alaska Airlines Inc.,949,50,725,34,958,2716
MCO,SFO,United Air Lines Inc.,1536,0,497,0,291,2324
MCO,SJU,American Airlines Inc.,3466,102,1833,5,9847,15253
MCO,SJU,Delta Air Lines Inc.,0,0,0,0,34,34
MCO,SJU,JetBlue Airways,870,3,131,0,1491,2495
MCO,SLC,Delta Air Lines Inc.,508,70,387,0,830,1795
MCO,SLC,Southwest Airlines Co.,178,0,119,0,50,347
MCO,STL,American Airlines Inc.,2629,97,315,0,3161,6202
MCO,STL,Southwest Airlines Co.,1663,563,597,25,4225,7073
MCO,SWF,JetBlue Airways,827,17,366,0,2908,4118
MCO,SYR,JetBlue Airways,448,66,348,10,1999,2871
MCO,TLH,Atlantic Southeast Airlines,289,81,27,0,41,438
MCO,TUL,Southwest Airlines Co.,0,39,29,0,194,262
MCO,TYS,Atlantic Southeast Airlines,107,31,0,0,0,138
MDT,ATL,Atlantic Southeast Airlines,3000,1804,2233,90,854,7981
MDT,CLT,US Airways Inc.,507,42,108,0,0,657
MDT,CVG,Atlantic Southeast Airlines,1072,890,483,0,221,2666
MDT,DFW,American Eagle Airlines Inc.,2398,404,807,0,0,3609
MDT,ORD,American Eagle Airlines Inc.,1042,385,2700,0,3362,7489
MDT,ORD,United Air Lines Inc.,1246,158,3861,0,2180,7445
MDW,ABQ,Southwest Airlines Co.,833,216,611,0,1866,3526
MDW,ALB,Southwest Airlines Co.,1124,276,377,8,1883,3668
MDW,ATL,Atlantic Southeast Airlines,270,81,88,0,0,439
MDW,AUS,Southwest Airlines Co.,1623,210,723,0,4219,6775
MDW,BDL,Southwest Airlines Co.,1793,365,666,2,4526,7352
MDW,BHM,Southwest Airlines Co.,1000,309,657,26,3426,5418
MDW,BNA,Southwest Airlines Co.,4428,553,2584,47,13348,20960
MDW,BUF,Southwest Airlines Co.,2223,269,655,91,4264,7502
MDW,BWI,Southwest Airlines Co.,4676,1496,1975,144,8028,16319
MDW,CLE,Southwest Airlines Co.,3943,1370,1592,5,6835,13745
MDW,CMH,Southwest Airlines Co.,5136,447,1474,64,9716,16837
MDW,DEN,Frontier Airlines Inc.,2295,157,2268,0,1462,6182
MDW,DEN,Southwest Airlines Co.,3954,766,1615,45,7640,14020
MDW,DTW,Southwest Airlines Co.,4270,428,1406,35,10257,16396
MDW,FLL,Southwest Airlines Co.,3057,799,876,0,3875,8607
MDW,HOU,Southwest Airlines Co.,3604,387,1969,24,8097,14081
MDW,IAD,Southwest Airlines Co.,3883,1606,2086,70,6547,14192
MDW,IND,Southwest Airlines Co.,3713,419,1547,12,5457,11148
MDW,ISP,Southwest Airlines Co.,2525,443,897,42,2176,6083
MDW,JAN,Southwest Airlines Co.,1575,221,485,19,5859,8159
MDW,LAS,Southwest Airlines Co.,4554,2292,5156,28,13921,25951
MDW,LAX,Southwest Airlines Co.,3848,372,2791,45,6826,13882
MDW,LIT,Southwest Airlines Co.,1468,60,237,0,1238,3003
MDW,MCI,Southwest Airlines Co.,7780,1954,3663,79,17981,31457
MDW,MCO,Southwest Airlines Co.,4548,614,2365,62,8289,15878
MDW,MHT,Southwest Airlines Co.,3664,325,534,0,3820,8343
MDW,MSY,Southwest Airlines Co.,227,30,321,0,517,1095
MDW,OAK,Southwest Airlines Co.,3142,468,2484,76,4927,11097
MDW,OMA,Southwest Airlines Co.,3641,854,1072,9,7451,13027
MDW,ORF,Southwest Airlines Co.,1151,272,926,11,2170,4530
MDW,PDX,Southwest Airlines Co.,1725,397,725,0,3085,5932
MDW,PHL,Southwest Airlines Co.,3737,5704,6287,26,8343,24097
MDW,PHX,Southwest Airlines Co.,4387,670,2690,43,12949,20739
MDW,PIT,Southwest Airlines Co.,3995,282,1555,27,5431,11290
MDW,PVD,Southwest Airlines Co.,2255,375,600,6,4297,7533
MDW,RDU,Southwest Airlines Co.,1723,640,907,0,4932,8202
MDW,RNO,Southwest Airlines Co.,554,46,459,35,813,1907
MDW,RSW,Southwest Airlines Co.,1334,315,598,0,3035,5282
MDW,SAN,Southwest Airlines Co.,2731,641,2093,47,6933,12445
MDW,SAT,Southwest Airlines Co.,1082,172,452,0,3103,4809
MDW,SDF,Southwest Airlines Co.,3136,1000,1582,45,7490,13253
MDW,SEA,Southwest Airlines Co.,2574,497,735,0,4457,8263
MDW,SFO,Southwest Airlines Co.,2086,2128,2755,0,3382,10351
MDW,SJC,Southwest Airlines Co.,1327,108,1011,0,3072,5518
MDW,SLC,Southwest Airlines Co.,2363,522,810,112,2958,6765
MDW,SMF,Southwest Airlines Co.,1196,122,945,2,3549,5814
MDW,STL,Southwest Airlines Co.,5912,1221,3591,59,15725,26508
MDW,TPA,Southwest Airlines Co.,2997,431,1285,21,6220,10954
MDW,TUS,Southwest Airlines Co.,1409,279,826,9,3285,5808
MEI,ATL,Atlantic Southeast Airlines,2332,393,1097,43,194,4059
MEM,ATL,Atlantic Southeast Airlines,2762,1404,1957,0,521,6644
MEM,ATL,Delta Air Lines Inc.,1434,455,1375,0,2079,5343
MEM,ATL,Skywest Airlines Inc.,86,183,0,0,171,440
MEM,CVG,Atlantic Southeast Airlines,1621,586,443,0,258,2908
MEM,DEN,Frontier Airlines Inc.,30,0,148,0,86,264
MEM,DEN,Skywest Airlines Inc.,2287,314,354,0,769,3724
MEM,DFW,American Airlines Inc.,1582,861,2201,0,5036,9680
MEM,FLL,Frontier Airlines Inc.,0,0,0,0,15,15
MEM,LGA,American Eagle Airlines Inc.,1995,190,3987,0,2660,8832
MEM,MCO,Frontier Airlines Inc.,119,0,1,0,0,120
MEM,MIA,American Eagle Airlines Inc.,652,40,190,0,1999,2881
MEM,ORD,American Eagle Airlines Inc.,2311,488,8502,0,9661,20962
MEM,ORD,Skywest Airlines Inc.,3144,431,17331,0,1484,22390
MFE,ATL,Atlantic Southeast Airlines,79,0,28,0,0,107
MFE,DFW,American Airlines Inc.,552,208,1340,0,4453,6553
MFR,DEN,Skywest Airlines Inc.,678,0,0,0,0,678
MFR,MOD,Skywest Airlines Inc.,16,0,0,0,0,16
MFR,PDX,Skywest Airlines Inc.,1539,348,272,0,1552,3711
MFR,SBA,Skywest Airlines Inc.,0,0,48,0,0,48
MFR,SFO,Skywest Airlines Inc.,4291,521,17851,82,3337,26082
MFR,SLC,Skywest Airlines Inc.,403,0,27,0,463,893
MGM,ATL,Atlantic Southeast Airlines,5793,1627,5091,0,162,12673
MHT,ATL,Atlantic Southeast Airlines,2747,172,862,0,188,3969
MHT,BWI,Southwest Airlines Co.,4043,2308,2522,102,10709,19684
MHT,CLT,US Airways Inc.,720,395,232,0,274,1621
MHT,CVG,Atlantic Southeast Airlines,0,107,0,0,0,107
MHT,DCA,US Airways Inc.,184,0,225,0,0,409
MHT,FLL,Southwest Airlines Co.,66,0,0,0,0,66
MHT,LAS,Southwest Airlines Co.,485,261,285,0,147,1178
MHT,MCO,Southwest Airlines Co.,1230,573,1148,36,3741,6728
MHT,MDW,Southwest Airlines Co.,1242,1435,1676,14,5946,10313
MHT,ORD,United Air Lines Inc.,2176,7,5377,0,3212,10772
MHT,PHL,Southwest Airlines Co.,1451,1654,5511,46,9776,18438
MHT,PHL,US Airways Inc.,224,0,464,0,97,785
MHT,PHX,Southwest Airlines Co.,507,84,304,0,341,1236
MHT,TPA,Southwest Airlines Co.,874,372,607,12,1434,3299
MIA,ATL,American Airlines Inc.,4608,323,2687,0,4830,12448
MIA,ATL,Delta Air Lines Inc.,4285,672,4861,49,4947,14814
MIA,BDL,American Airlines Inc.,2048,146,364,0,973,3531
MIA,BNA,American Airlines Inc.,2207,105,215,0,1911,4438
MIA,BOS,American Airlines Inc.,9320,389,3489,13,6306,19517
MIA,BWI,American Airlines Inc.,3485,955,389,0,1583,6412
MIA,CLE,American Eagle Airlines Inc.,283,0,47,0,577,907
MIA,CLT,American Eagle Airlines Inc.,4643,314,699,0,4008,9664
MIA,CLT,US Airways Inc.,2157,120,1002,15,2972,6266
MIA,CMH,American Eagle Airlines Inc.,997,111,210,0,546,1864
MIA,CVG,American Eagle Airlines Inc.,1443,207,165,0,488,2303
MIA,DCA,American Airlines Inc.,8563,797,2424,38,6573,18395
MIA,DEN,American Airlines Inc.,2308,129,654,0,1149,4240
MIA,DEN,United Air Lines Inc.,1096,100,705,0,2373,4274
MIA,DFW,American Airlines Inc.,12776,1023,3231,11,4260,21301
MIA,DTW,American Airlines Inc.,1387,73,262,0,1218,2940
MIA,EGE,American Airlines Inc.,111,23,142,0,21,297
MIA,EWR,American Airlines Inc.,5545,241,5448,0,5409,16643
MIA,GSO,American Eagle Airlines Inc.,748,77,116,0,232,1173
MIA,IAD,American Airlines Inc.,1003,211,600,0,1153,2967
MIA,IAD,United Air Lines Inc.,683,35,42,0,241,1001
MIA,IAH,American Airlines Inc.,3206,189,1346,0,2487,7228
MIA,IND,American Eagle Airlines Inc.,1018,0,153,0,174,1345
MIA,JAX,American Eagle Airlines Inc.,94,53,202,0,250,599
MIA,JFK,American Airlines Inc.,15273,803,7716,87,11603,35482
MIA,JFK,Delta Air Lines Inc.,1161,194,1773,0,2444,5572
MIA,LAS,American Airlines Inc.,3060,254,999,0,1672,5985
MIA,LAS,US Airways Inc.,90,0,79,0,197,366
MIA,LAX,American Airlines Inc.,12942,1095,4715,47,6989,25788
MIA,LGA,American Airlines Inc.,10823,688,20830,0,7877,40218
MIA,MCO,American Airlines Inc.,12529,513,2269,17,8371,23699
MIA,MEM,American Eagle Airlines Inc.,1297,360,255,0,555,2467
MIA,MSP,American Airlines Inc.,631,34,332,0,413,1410
MIA,MSY,American Airlines Inc.,3052,145,1047,0,3615,7859
MIA,ORD,American Airlines Inc.,12518,725,18996,7,13813,46059
MIA,ORD,United Air Lines Inc.,61,0,13,0,16,90
MIA,ORF,American Eagle Airlines Inc.,1020,60,225,0,621,1926
MIA,PHL,American Airlines Inc.,3815,521,3284,0,4570,12190
MIA,PHL,US Airways Inc.,1722,152,1772,0,3166,6812
MIA,PHX,American Airlines Inc.,1704,245,954,0,1371,4274
MIA,PIT,American Eagle Airlines Inc.,316,217,42,0,141,716
MIA,PIT,US Airways Inc.,51,0,4,0,67,122
MIA,RDU,American Airlines Inc.,4258,190,774,3,2239,7464
MIA,RIC,American Eagle Airlines Inc.,1337,139,13,0,668,2157
MIA,SDF,American Eagle Airlines Inc.,1348,443,193,0,591,2575
MIA,SEA,Alaska Airlines Inc.,314,0,161,0,923,1398
MIA,SFO,American Airlines Inc.,4666,219,2583,0,2017,9485
MIA,SJU,American Airlines Inc.,19499,911,3687,5,9864,33966
MIA,STL,American Airlines Inc.,2420,172,570,0,2763,5925
MIA,STT,American Airlines Inc.,3795,752,600,0,3829,8976
MIA,STX,American Airlines Inc.,1309,95,282,0,1204,2890
MIA,TLH,American Eagle Airlines Inc.,924,304,65,17,438,1748
MIA,TLH,Atlantic Southeast Airlines,119,197,225,0,0,541
MIA,TPA,American Airlines Inc.,4890,126,1087,0,3420,9523
MIA,XNA,American Eagle Airlines Inc.,1345,73,110,0,3,1531
MKE,ATL,Atlantic Southeast Airlines,5284,2402,3563,0,2897,14146
MKE,ATL,Delta Air Lines Inc.,1337,634,155,0,0,2126
MKE,ATL,Skywest Airlines Inc.,409,0,32,0,170,611
MKE,ATW,Skywest Airlines Inc.,2614,682,163,0,600,4059
MKE,BDL,Skywest Airlines Inc.,1383,1020,935,0,194,3532
MKE,BNA,Skywest Airlines Inc.,2132,211,294,0,870,3507
MKE,BWI,Skywest Airlines Inc.,2890,923,956,0,300,5069
MKE,CLE,Skywest Airlines Inc.,442,238,690,0,657,2027
MKE,CLT,Skywest Airlines Inc.,1008,680,94,0,0,1782
MKE,CMH,Skywest Airlines Inc.,5313,1265,962,18,727,8285
MKE,CVG,Atlantic Southeast Airlines,46,0,0,0,0,46
MKE,CWA,Skywest Airlines Inc.,752,179,298,0,484,1713
MKE,DAY,Skywest Airlines Inc.,1092,238,314,0,283,1927
MKE,DEN,Frontier Airlines Inc.,1655,599,1707,0,964,4925
MKE,DEN,Skywest Airlines Inc.,333,186,227,0,1378,2124
MKE,DFW,American Eagle Airlines Inc.,1409,236,1047,2,2232,4926
MKE,DSM,Skywest Airlines Inc.,1112,290,428,0,603,2433
MKE,EWR,Skywest Airlines Inc.,3699,1278,24014,0,578,29569
MKE,FNT,Skywest Airlines Inc.,1619,879,207,0,427,3132
MKE,GRB,Skywest Airlines Inc.,1636,205,309,0,719,2869
MKE,GRR,Skywest Airlines Inc.,4060,1134,816,0,758,6768
MKE,IND,Skywest Airlines Inc.,838,256,478,0,923,2495
MKE,MKG,Skywest Airlines Inc.,956,44,241,0,1429,2670
MKE,MQT,American Eagle Airlines Inc.,12,673,1871,0,6794,9350
MKE,MSN,Skywest Airlines Inc.,4921,588,436,0,692,6637
MKE,MSP,Skywest Airlines Inc.,8102,1165,1143,0,758,11168
MKE,OMA,Skywest Airlines Inc.,3210,191,325,0,479,4205
MKE,ORD,American Eagle Airlines Inc.,2186,996,6691,0,9291,19164
MKE,ORD,Skywest Airlines Inc.,946,1025,12622,0,2233,16826
MKE,PHL,Skywest Airlines Inc.,2390,311,3985,26,629,7341
MKE,PHX,US Airways Inc.,1252,276,221,0,238,1987
MKE,PIT,Skywest Airlines Inc.,6416,1426,731,0,649,9222
MKE,RDU,Skywest Airlines Inc.,2606,913,491,0,301,4311
MKE,SDF,Skywest Airlines Inc.,219,20,276,0,299,814
MKE,STL,Skywest Airlines Inc.,1002,245,130,0,378,1755
MKG,FNT,Skywest Airlines Inc.,594,0,373,0,584,1551
MKG,GRR,Skywest Airlines Inc.,278,296,12,0,235,821
MKG,MKE,Skywest Airlines Inc.,148,33,70,0,145,396
MLB,ATL,Atlantic Southeast Airlines,3150,277,1577,115,843,5962
MLB,ATL,Delta Air Lines Inc.,765,9,1803,0,825,3402
MLI,ATL,Atlantic Southeast Airlines,5335,1141,2062,49,507,9094
MLI,DEN,Skywest Airlines Inc.,1339,191,508,0,3791,5829
MLI,DFW,American Eagle Airlines Inc.,182,184,456,0,2078,2900
MLI,ORD,American Eagle Airlines Inc.,924,369,6187,16,6253,13749
MLI,ORD,Skywest Airlines Inc.,45,659,6224,0,862,7790
MLU,ATL,Atlantic Southeast Airlines,3078,712,1835,0,224,5849
MLU,DFW,American Eagle Airlines Inc.,1916,1281,373,20,847,4437
MOB,ATL,Atlantic Southeast Airlines,6720,2226,3611,0,431,12988
MOB,ATL,Delta Air Lines Inc.,167,128,351,0,105,751
MOB,ATL,Skywest Airlines Inc.,6,11,27,0,46,90
MOB,DFW,American Eagle Airlines Inc.,1904,1041,1669,0,3401,8015
MOB,ORD,American Eagle Airlines Inc.,222,472,1309,0,2075,4078
MOD,LAX,Skywest Airlines Inc.,1658,102,82,0,1253,3095
MOD,SFO,Skywest Airlines Inc.,2227,42,7849,59,4084,14261
MQT,GRB,American Eagle Airlines Inc.,2095,176,285,0,0,2556
MQT,MKE,American Eagle Airlines Inc.,3348,285,368,0,389,4390
MQT,ORD,American Eagle Airlines Inc.,1335,202,1140,0,14,2691
MRY,DEN,Skywest Airlines Inc.,77,0,32,0,20,129
MRY,LAX,American Eagle Airlines Inc.,3056,149,113,0,1090,4408
MRY,LAX,Skywest Airlines Inc.,4310,364,963,13,5519,11169
MRY,SFO,Skywest Airlines Inc.,2893,457,13212,0,2897,19459
MRY,SLC,Skywest Airlines Inc.,62,0,0,0,73,135
MSN,ATL,Atlantic Southeast Airlines,2093,590,368,0,255,3306
MSN,DEN,Skywest Airlines Inc.,858,86,291,0,2872,4107
MSN,DFW,American Eagle Airlines Inc.,1036,350,1002,0,1574,3962
MSN,LGA,American Eagle Airlines Inc.,12,6,2781,0,1942,4741
MSN,MCI,Skywest Airlines Inc.,761,198,34,93,0,1086
MSN,MKE,Skywest Airlines Inc.,2686,997,335,0,348,4366
MSN,ORD,American Eagle Airlines Inc.,2211,672,10048,0,10627,23558
MSN,ORD,Skywest Airlines Inc.,817,1234,15194,0,3938,21183
MSO,DEN,Skywest Airlines Inc.,148,30,102,0,1593,1873
MSO,DEN,United Air Lines Inc.,737,0,50,0,192,979
MSO,ORD,Skywest Airlines Inc.,0,0,1429,0,63,1492
MSO,SLC,Skywest Airlines Inc.,1052,118,332,0,2276,3778
MSP,ATL,Atlantic Southeast Airlines,569,281,382,0,509,1741
MSP,ATL,Delta Air Lines Inc.,576,26,541,0,2158,3301
MSP,ATL,Skywest Airlines Inc.,354,90,174,0,509,1127
MSP,CLT,US Airways Inc.,1112,44,369,30,976,2531
MSP,DEN,Frontier Airlines Inc.,907,35,1464,0,1353,3759
MSP,DEN,United Air Lines Inc.,4765,101,1489,0,7001,13356
MSP,DFW,American Airlines Inc.,2701,335,1616,0,4762,9414
MSP,LAS,US Airways Inc.,1025,91,686,0,1056,2858
MSP,LGA,American Airlines Inc.,124,9,3345,0,2009,5487
MSP,MIA,American Airlines Inc.,887,516,153,0,0,1556
MSP,MKE,Skywest Airlines Inc.,7283,1611,847,0,307,10048
MSP,ORD,American Airlines Inc.,2081,163,10974,0,11499,24717
MSP,ORD,United Air Lines Inc.,4999,312,15881,0,13903,35095
MSP,PHX,US Airways Inc.,1417,16,434,0,899,2766
MSP,SLC,Delta Air Lines Inc.,21,0,83,0,453,557
MSP,SLC,Skywest Airlines Inc.,1171,508,606,0,1724,4009
MSY,ATL,Atlantic Southeast Airlines,510,0,60,0,202,772
MSY,ATL,Delta Air Lines Inc.,2873,204,3068,0,5794,11939
MSY,BHM,Southwest Airlines Co.,248,44,42,0,2273,2607
MSY,BNA,Southwest Airlines Co.,366,80,154,0,1601,2201
MSY,BOS,JetBlue Airways,16,0,26,0,118,160
MSY,BWI,Southwest Airlines Co.,159,172,36,0,171,538
MSY,CLT,US Airways Inc.,1039,20,495,43,2723,4320
MSY,DAL,Southwest Airlines Co.,1982,775,1278,17,7444,11496
MSY,DCA,US Airways Inc.,341,0,27,10,197,575
MSY,DEN,United Air Lines Inc.,1179,122,872,0,5326,7499
MSY,DFW,American Airlines Inc.,4663,185,3958,0,9594,18400
MSY,FLL,Southwest Airlines Co.,349,179,212,16,2409,3165
MSY,HOU,Southwest Airlines Co.,2506,1777,2970,51,17621,24925
MSY,IAD,United Air Lines Inc.,655,0,255,0,4680,5590
MSY,JFK,JetBlue Airways,1798,0,1370,0,2958,6126
MSY,LAS,Southwest Airlines Co.,648,298,571,6,1229,2752
MSY,LAX,Delta Air Lines Inc.,116,20,223,0,639,998
MSY,LAX,United Air Lines Inc.,1118,36,392,0,1261,2807
MSY,LGA,American Airlines Inc.,248,2,1878,0,486,2614
MSY,LGA,Delta Air Lines Inc.,299,0,1194,0,1386,2879
MSY,MCO,Atlantic Southeast Airlines,63,8,73,0,0,144
MSY,MCO,Southwest Airlines Co.,948,323,330,0,5702,7303
MSY,MDW,Southwest Airlines Co.,399,68,81,0,662,1210
MSY,MIA,American Airlines Inc.,1850,33,654,0,4548,7085
MSY,ORD,American Airlines Inc.,537,53,6276,0,4938,11804
MSY,ORD,United Air Lines Inc.,2074,0,3155,0,1301,6530
MSY,PHL,US Airways Inc.,513,79,5181,0,990,6763
MSY,PHX,Southwest Airlines Co.,562,162,217,0,1266,2207
MSY,SLC,Skywest Airlines Inc.,1240,95,100,0,16,1451
MSY,TPA,Southwest Airlines Co.,1235,392,214,11,3989,5841
MTJ,ATL,Delta Air Lines Inc.,115,0,69,0,149,333
MTJ,ATL,Skywest Airlines Inc.,96,62,34,29,18,239
MTJ,DEN,Skywest Airlines Inc.,0,61,0,0,0,61
MTJ,DEN,United Air Lines Inc.,28,9,32,0,193,262
MTJ,DFW,American Airlines Inc.,43,30,123,24,309,529
MTJ,DFW,American Eagle Airlines Inc.,1094,0,430,18,1194,2736
MTJ,LAX,Skywest Airlines Inc.,27,0,0,0,325,352
MTJ,ORD,American Airlines Inc.,0,0,3,0,246,249
MTJ,SLC,Skywest Airlines Inc.,681,502,272,16,1467,2938
MYR,ATL,Atlantic Southeast Airlines,4688,1081,3247,0,554,9570
MYR,CLT,US Airways Inc.,396,153,533,0,1919,3001
OAJ,ATL,Atlantic Southeast Airlines,3102,1461,1396,0,712,6671
OAK,ABQ,Southwest Airlines Co.,906,0,220,0,2378,3504
OAK,ATL,Delta Air Lines Inc.,224,0,17,0,657,898
OAK,AUS,Southwest Airlines Co.,32,0,0,0,0,32
OAK,BNA,Southwest Airlines Co.,475,0,75,0,357,907
OAK,BOI,Southwest Airlines Co.,724,2,177,54,1569,2526
OAK,BOS,JetBlue Airways,104,0,121,0,730,955
OAK,BUR,Southwest Airlines Co.,4758,0,470,73,13034,18335
OAK,DEN,Southwest Airlines Co.,2122,0,417,20,3992,6551
OAK,DEN,United Air Lines Inc.,911,67,500,0,4297,5775
OAK,DFW,American Airlines Inc.,1109,105,438,0,1901,3553
OAK,FLL,JetBlue Airways,9,0,10,0,146,165
OAK,GEG,Southwest Airlines Co.,817,0,192,0,1826,2835
OAK,HOU,Southwest Airlines Co.,472,0,190,17,712,1391
OAK,IAD,JetBlue Airways,943,0,130,0,1389,2462
OAK,IAD,United Air Lines Inc.,87,0,43,0,196,326
OAK,JFK,JetBlue Airways,782,0,1179,0,1593,3554
OAK,LAS,Southwest Airlines Co.,4674,1105,2879,52,11192,19902
OAK,LAS,US Airways Inc.,11,0,216,0,370,597
OAK,LAX,Skywest Airlines Inc.,1380,398,672,0,3220,5670
OAK,LAX,Southwest Airlines Co.,6236,552,3358,215,19690,30051
OAK,LGB,JetBlue Airways,613,118,126,0,1722,2579
OAK,MCI,Southwest Airlines Co.,830,0,157,8,557,1552
OAK,MDW,Southwest Airlines Co.,2406,192,723,16,3139,6476
OAK,ONT,Southwest Airlines Co.,3466,17,305,94,9968,13850
OAK,ORD,United Air Lines Inc.,66,6,1219,0,444,1735
OAK,PDX,Alaska Airlines Inc.,678,0,103,0,602,1383
OAK,PDX,Southwest Airlines Co.,1950,11,654,40,8050,10705
OAK,PHX,Southwest Airlines Co.,2969,50,748,40,5826,9633
OAK,PHX,US Airways Inc.,1773,10,203,0,563,2549
OAK,RNO,Southwest Airlines Co.,1017,208,245,56,4142,5668
OAK,SAN,Southwest Airlines Co.,6291,101,1017,175,14182,21766
OAK,SEA,Alaska Airlines Inc.,3477,1,651,0,2755,6884
OAK,SEA,Southwest Airlines Co.,2387,49,1003,42,8476,11957
OAK,SLC,Delta Air Lines Inc.,22,0,25,0,0,47
OAK,SLC,Skywest Airlines Inc.,267,0,215,107,2438,3027
OAK,SLC,Southwest Airlines Co.,1863,594,497,58,4405,7417
OAK,SNA,Alaska Airlines Inc.,581,33,128,0,1573,2315
OAK,SNA,Southwest Airlines Co.,1840,143,326,28,5328,7665
OAK,TUS,Southwest Airlines Co.,369,0,17,0,393,779
OGG,DEN,United Air Lines Inc.,261,0,67,0,0,328
OGG,DFW,American Airlines Inc.,3106,0,416,0,1320,4842
OGG,HNL,Hawaiian Airlines Inc.,1264,0,0,0,3713,4977
OGG,ITO,Hawaiian Airlines Inc.,6,0,0,0,90,96
OGG,KOA,Hawaiian Airlines Inc.,124,0,0,0,198,322
OGG,KOA,United Air Lines Inc.,183,0,40,0,911,1134
OGG,LAX,American Airlines Inc.,4111,0,593,0,4243,8947
OGG,LAX,Delta Air Lines Inc.,126,0,99,0,1490,1715
OGG,LAX,United Air Lines Inc.,469,0,127,0,1528,2124
OGG,PDX,Hawaiian Airlines Inc.,833,0,0,0,509,1342
OGG,PHX,US Airways Inc.,2028,0,304,0,1006,3338
OGG,SAN,Hawaiian Airlines Inc.,425,0,0,0,209,634
OGG,SEA,Hawaiian Airlines Inc.,1391,0,0,0,255,1646
OGG,SFO,United Air Lines Inc.,2502,0,512,0,3482,6496
OGG,SLC,Delta Air Lines Inc.,358,0,61,0,140,559
OKC,ATL,Atlantic Southeast Airlines,6088,1075,1660,0,775,9598
OKC,ATL,Delta Air Lines Inc.,166,0,157,0,0,323
OKC,ATL,Skywest Airlines Inc.,172,0,553,0,303,1028
OKC,BMI,Skywest Airlines Inc.,34,0,4,0,0,38
OKC,BWI,Southwest Airlines Co.,141,31,3,0,431,606
OKC,DAL,Southwest Airlines Co.,950,614,635,0,8236,10435
OKC,DEN,Frontier Airlines Inc.,252,0,737,0,398,1387
OKC,DEN,Skywest Airlines Inc.,238,132,191,50,1249,1860
OKC,DEN,Southwest Airlines Co.,471,111,239,0,4026,4847
OKC,DEN,United Air Lines Inc.,805,18,353,0,2510,3686
OKC,DFW,American Airlines Inc.,2427,538,1651,29,4796,9441
OKC,DFW,American Eagle Airlines Inc.,328,437,905,0,1325,2995
OKC,HOU,Southwest Airlines Co.,808,364,1087,0,6685,8944
OKC,LAS,Southwest Airlines Co.,148,27,483,0,1579,2237
OKC,LAX,Skywest Airlines Inc.,549,134,421,0,2020,3124
OKC,MCI,Southwest Airlines Co.,703,236,170,0,4918,6027
OKC,MCO,Southwest Airlines Co.,29,0,0,0,0,29
OKC,ORD,American Eagle Airlines Inc.,1207,318,7178,8,8522,17233
OKC,ORD,Skywest Airlines Inc.,116,115,5492,0,975,6698
OKC,PHX,Southwest Airlines Co.,896,80,235,0,1467,2678
OKC,SLC,Skywest Airlines Inc.,102,0,2,0,52,156
OKC,STL,Southwest Airlines Co.,459,126,205,0,2467,3257
OMA,ATL,Atlantic Southeast Airlines,7726,2024,2072,0,854,12676
OMA,ATL,Skywest Airlines Inc.,257,0,13,0,0,270
OMA,BHM,Skywest Airlines Inc.,10,0,15,0,0,25
OMA,CVG,Atlantic Southeast Airlines,160,39,9,0,0,208
OMA,DEN,Frontier Airlines Inc.,467,0,262,0,323,1052
OMA,DEN,United Air Lines Inc.,3095,378,1480,0,8906,13859
OMA,DFW,American Airlines Inc.,1664,120,869,0,3364,6017
OMA,LAS,Southwest Airlines Co.,511,131,1090,0,2167,3899
OMA,MDW,Southwest Airlines Co.,1658,1030,2095,0,5159,9942
OMA,MKE,Skywest Airlines Inc.,1314,532,164,0,374,2384
OMA,ORD,American Eagle Airlines Inc.,3480,164,10272,0,11543,25459
OMA,ORD,Skywest Airlines Inc.,228,590,7642,0,2660,11120
OMA,ORD,United Air Lines Inc.,817,86,5833,0,5477,12213
OMA,PHX,Southwest Airlines Co.,921,99,540,9,4528,6097
OMA,PHX,US Airways Inc.,1078,253,166,0,685,2182
OMA,SLC,Skywest Airlines Inc.,501,230,38,0,941,1710
OMA,STL,Southwest Airlines Co.,814,213,263,0,1942,3232
OME,ANC,Alaska Airlines Inc.,111,214,45,119,1328,1817
OME,OTZ,Alaska Airlines Inc.,127,8,77,0,984,1196
ONT,ATL,Delta Air Lines Inc.,1261,92,316,0,1362,3031
ONT,BNA,Southwest Airlines Co.,61,0,27,0,294,382
ONT,DEN,United Air Lines Inc.,1699,8,613,0,5670,7990
ONT,DFW,American Airlines Inc.,1569,179,380,0,3249,5377
ONT,JFK,JetBlue Airways,101,0,80,0,1241,1422
ONT,LAS,Southwest Airlines Co.,1616,200,3277,19,8551,13663
ONT,LAS,US Airways Inc.,117,0,152,0,376,645
ONT,LAX,Skywest Airlines Inc.,58,0,119,0,369,546
ONT,OAK,Southwest Airlines Co.,2661,52,1267,11,12712,16703
ONT,PDX,Alaska Airlines Inc.,243,3,215,0,959,1420
ONT,PHX,Southwest Airlines Co.,1457,337,1635,2,7642,11073
ONT,PHX,US Airways Inc.,1349,0,357,0,1926,3632
ONT,RNO,Southwest Airlines Co.,45,0,0,0,65,110
ONT,SEA,Alaska Airlines Inc.,1807,82,402,0,2306,4597
ONT,SFO,Skywest Airlines Inc.,1785,142,11906,0,5289,19122
ONT,SJC,Southwest Airlines Co.,1831,136,478,5,8010,10460
ONT,SLC,Delta Air Lines Inc.,158,0,17,0,346,521
ONT,SLC,Skywest Airlines Inc.,692,0,12,0,1143,1847
ONT,SMF,Southwest Airlines Co.,1881,72,671,20,10322,12966
ORD,ABE,Skywest Airlines Inc.,1082,184,224,0,6152,7642
ORD,ABQ,American Airlines Inc.,2103,441,905,0,3824,7273
ORD,ABQ,Skywest Airlines Inc.,351,0,209,6,66,632
ORD,ALB,American Eagle Airlines Inc.,2835,571,1976,0,2667,8049
ORD,ALB,United Air Lines Inc.,1798,165,808,0,5497,8268
ORD,ANC,Alaska Airlines Inc.,230,45,432,0,4348,5055
ORD,ANC,United Air Lines Inc.,383,20,171,0,536,1110
ORD,ASE,Skywest Airlines Inc.,927,465,0,30,2796,4218
ORD,ATL,American Airlines Inc.,2310,768,2420,0,6236,11734
ORD,ATL,American Eagle Airlines Inc.,2584,360,1126,0,2971,7041
ORD,ATL,Delta Air Lines Inc.,3768,1193,4035,0,8307,17303
ORD,ATL,Skywest Airlines Inc.,581,271,543,51,1161,2607
ORD,ATL,United Air Lines Inc.,5506,1571,4008,0,10750,21835
ORD,ATW,Skywest Airlines Inc.,1321,333,485,0,6660,8799
ORD,AUS,American Airlines Inc.,4272,1219,2824,0,7426,15741
ORD,AUS,Skywest Airlines Inc.,1065,605,364,0,3814,5848
ORD,AVP,Skywest Airlines Inc.,314,196,317,0,2011,2838
ORD,AZO,American Eagle Airlines Inc.,3276,738,1789,0,5929,11732
ORD,AZO,Skywest Airlines Inc.,1510,85,267,0,3962,5824
ORD,BDL,American Eagle Airlines Inc.,4670,1406,2712,0,5400,14188
ORD,BDL,United Air Lines Inc.,5316,1304,2500,0,13639,22759
ORD,BHM,American Eagle Airlines Inc.,1428,210,689,0,1420,3747
ORD,BHM,Skywest Airlines Inc.,1725,403,606,0,5996,8730
ORD,BIL,Skywest Airlines Inc.,41,0,92,0,312,445
ORD,BMI,American Eagle Airlines Inc.,2330,664,1516,0,4845,9355
ORD,BMI,Skywest Airlines Inc.,510,0,244,0,1532,2286
ORD,BNA,American Airlines Inc.,1100,379,850,0,4118,6447
ORD,BNA,American Eagle Airlines Inc.,9144,2339,4688,0,10156,26327
ORD,BNA,Skywest Airlines Inc.,1756,91,335,0,4783,6965
ORD,BOI,Skywest Airlines Inc.,1612,217,528,57,2895,5309
ORD,BOI,United Air Lines Inc.,1213,93,463,0,3007,4776
ORD,BOS,American Airlines Inc.,6163,2123,7497,0,15064,30847
ORD,BOS,JetBlue Airways,160,0,66,0,585,811
ORD,BOS,United Air Lines Inc.,8443,1716,8795,0,18043,36997
ORD,BTR,American Eagle Airlines Inc.,934,293,522,0,610,2359
ORD,BTV,Skywest Airlines Inc.,305,17,91,0,829,1242
ORD,BTV,United Air Lines Inc.,1855,247,895,0,4564,7561
ORD,BUF,American Eagle Airlines Inc.,3134,955,2451,0,4329,10869
ORD,BUF,United Air Lines Inc.,4835,670,1050,0,9383,15938
ORD,BWI,American Eagle Airlines Inc.,3695,766,2313,0,4753,11527
ORD,BWI,United Air Lines Inc.,5784,1111,2786,0,13734,23415
ORD,BZN,Skywest Airlines Inc.,1185,89,90,0,1845,3209
ORD,BZN,United Air Lines Inc.,377,29,162,0,29,597
ORD,CAK,Skywest Airlines Inc.,478,358,212,0,3405,4453
ORD,CHA,American Eagle Airlines Inc.,2194,155,1659,0,4667,8675
ORD,CHS,Skywest Airlines Inc.,832,170,262,0,5151,6415
ORD,CID,American Eagle Airlines Inc.,5044,1086,3399,0,6991,16520
ORD,CID,Skywest Airlines Inc.,2073,406,813,52,6300,9644
ORD,CLE,American Eagle Airlines Inc.,6143,1270,3280,0,6766,17459
ORD,CLE,Skywest Airlines Inc.,1029,39,303,0,4745,6116
ORD,CLE,United Air Lines Inc.,3059,643,1736,0,8093,13531
ORD,CLT,American Eagle Airlines Inc.,4128,1013,3624,0,7032,15797
ORD,CLT,US Airways Inc.,3473,306,2044,19,9847,15689
ORD,CLT,United Air Lines Inc.,3375,402,1509,0,5089,10375
ORD,CMH,American Eagle Airlines Inc.,15621,3346,8197,0,18634,45798
ORD,CMH,Skywest Airlines Inc.,223,0,24,0,180,427
ORD,CMH,United Air Lines Inc.,2985,540,1108,0,8567,13200
ORD,CMI,American Eagle Airlines Inc.,10938,1960,4911,14,13071,30894
ORD,COS,Skywest Airlines Inc.,3184,433,1106,0,10384,15107
ORD,CPR,Skywest Airlines Inc.,345,0,134,0,737,1216
ORD,CRW,Skywest Airlines Inc.,895,506,782,0,9096,11279
ORD,CVG,American Eagle Airlines Inc.,4966,1021,3326,0,7431,16744
ORD,CVG,Delta Air Lines Inc.,20,0,169,0,367,556
ORD,CVG,Skywest Airlines Inc.,1856,384,869,25,3009,6143
ORD,CVG,United Air Lines Inc.,1799,184,853,0,4901,7737
ORD,CWA,American Eagle Airlines Inc.,317,0,302,0,306,925
ORD,CWA,Skywest Airlines Inc.,987,146,136,0,3356,4625
ORD,DAY,American Eagle Airlines Inc.,2681,422,2000,0,2816,7919
ORD,DAY,Skywest Airlines Inc.,2102,82,378,0,2529,5091
ORD,DAY,United Air Lines Inc.,2418,217,505,0,4493,7633
ORD,DBQ,American Eagle Airlines Inc.,2686,1650,2013,0,4129,10478
ORD,DCA,American Airlines Inc.,4430,1561,4541,0,12151,22683
ORD,DCA,American Eagle Airlines Inc.,1045,107,468,0,1220,2840
ORD,DCA,United Air Lines Inc.,11476,2050,5982,0,20424,39932
ORD,DEN,American Airlines Inc.,4672,1279,4182,0,10026,20159
ORD,DEN,Skywest Airlines Inc.,102,80,0,0,0,182
ORD,DEN,United Air Lines Inc.,14227,2022,5627,0,15192,37068
ORD,DFW,American Airlines Inc.,14457,5366,8893,54,22309,51079
ORD,DFW,Skywest Airlines Inc.,661,22,179,0,337,1199
ORD,DFW,United Air Lines Inc.,5128,717,2696,0,10925,19466
ORD,DSM,American Eagle Airlines Inc.,6972,1641,4385,0,9463,22461
ORD,DSM,Skywest Airlines Inc.,1509,763,728,43,5208,8251
ORD,DSM,United Air Lines Inc.,1756,545,626,0,4920,7847
ORD,DTW,American Airlines Inc.,3315,1121,2464,0,11014,17914
ORD,DTW,American Eagle Airlines Inc.,2427,568,1602,0,2380,6977
ORD,DTW,Skywest Airlines Inc.,1044,47,305,0,1588,2984
ORD,DTW,United Air Lines Inc.,5875,757,2073,0,11869,20574
ORD,EGE,American Airlines Inc.,523,287,371,0,165,1346
ORD,EGE,United Air Lines Inc.,397,7,207,0,1394,2005
ORD,ELP,American Airlines Inc.,1664,783,1931,0,4949,9327
ORD,EVV,American Eagle Airlines Inc.,4245,1325,3135,0,6549,15254
ORD,EWR,American Airlines Inc.,2111,957,11555,0,7621,22244
ORD,EWR,United Air Lines Inc.,4598,1190,16488,0,14305,36581
ORD,FAR,Skywest Airlines Inc.,2736,316,709,0,9390,13151
ORD,FCA,Skywest Airlines Inc.,485,0,232,0,166,883
ORD,FLL,American Airlines Inc.,2384,905,1000,0,2834,7123
ORD,FLL,United Air Lines Inc.,3726,475,1566,0,4862,10629
ORD,FNT,American Eagle Airlines Inc.,4035,751,1824,0,6151,12761
ORD,FSD,Skywest Airlines Inc.,2144,712,1095,0,12260,16211
ORD,FWA,American Eagle Airlines Inc.,4334,882,2883,0,6609,14708
ORD,FWA,Skywest Airlines Inc.,1387,43,181,0,4968,6579
ORD,GEG,United Air Lines Inc.,1678,527,482,0,4517,7204
ORD,GPT,American Eagle Airlines Inc.,457,194,660,0,481,1792
ORD,GRB,American Eagle Airlines Inc.,4313,1042,2748,0,7813,15916
ORD,GRB,Skywest Airlines Inc.,1720,553,427,0,7500,10200
ORD,GRR,American Eagle Airlines Inc.,6568,1172,3214,0,6928,17882
ORD,GRR,Skywest Airlines Inc.,566,63,83,0,1206,1918
ORD,GRR,United Air Lines Inc.,2475,336,753,0,7239,10803
ORD,GSO,United Air Lines Inc.,2088,234,804,0,5344,8470
ORD,GSP,American Eagle Airlines Inc.,1891,260,1743,0,4056,7950
ORD,GTF,Skywest Airlines Inc.,79,0,7,0,4,90
ORD,HDN,American Airlines Inc.,581,328,245,0,721,1875
ORD,HDN,Skywest Airlines Inc.,755,0,0,21,829,1605
ORD,HNL,American Airlines Inc.,1546,311,459,0,9,2325
ORD,HNL,United Air Lines Inc.,1257,181,291,0,0,1729
ORD,HPN,American Eagle Airlines Inc.,6047,1861,5339,0,7768,21015
ORD,HPN,Skywest Airlines Inc.,2098,213,727,0,6216,9254
ORD,HSV,American Eagle Airlines Inc.,1509,189,861,0,1241,3800
ORD,IAD,United Air Lines Inc.,9178,1223,4076,0,12526,27003
ORD,IAH,American Airlines Inc.,2676,898,2275,0,5328,11177
ORD,IAH,Skywest Airlines Inc.,632,0,431,0,1893,2956
ORD,IAH,United Air Lines Inc.,1956,444,1062,0,4462,7924
ORD,ICT,American Eagle Airlines Inc.,3826,1430,3380,0,6635,15271
ORD,ICT,Skywest Airlines Inc.,1444,140,648,0,4499,6731
ORD,ICT,United Air Lines Inc.,1711,391,619,0,5086,7807
ORD,IND,American Airlines Inc.,628,220,516,0,2394,3758
ORD,IND,American Eagle Airlines Inc.,9142,2255,5018,0,9687,26102
ORD,IND,Skywest Airlines Inc.,991,85,574,0,6476,8126
ORD,IND,United Air Lines Inc.,868,154,258,0,1409,2689
ORD,JAC,American Airlines Inc.,1122,249,300,0,880,2551
ORD,JAC,United Air Lines Inc.,745,557,627,0,883,2812
ORD,JAN,American Eagle Airlines Inc.,625,323,746,0,959,2653
ORD,JAX,American Eagle Airlines Inc.,3188,612,1884,0,3170,8854
ORD,JAX,United Air Lines Inc.,2740,428,1378,0,6565,11111
ORD,JFK,American Airlines Inc.,1394,510,2718,0,2356,6978
ORD,JFK,American Eagle Airlines Inc.,816,151,990,0,832,2789
ORD,JFK,JetBlue Airways,2075,56,4301,8,13181,19621
ORD,LAN,Skywest Airlines Inc.,480,0,161,19,5577,6237
ORD,LAS,American Airlines Inc.,4052,1247,3511,0,4563,13373
ORD,LAS,US Airways Inc.,3926,393,2561,14,9851,16745
ORD,LAS,United Air Lines Inc.,7998,1497,5196,0,10598,25289
ORD,LAX,American Airlines Inc.,12372,2975,9815,0,15854,41016
ORD,LAX,United Air Lines Inc.,11301,2901,7426,0,15463,37091
ORD,LEX,American Eagle Airlines Inc.,2431,615,1627,0,3562,8235
ORD,LEX,Skywest Airlines Inc.,1970,324,669,27,9774,12764
ORD,LGA,American Airlines Inc.,10198,2539,34568,0,27014,74319
ORD,LGA,United Air Lines Inc.,10723,1696,35001,0,24551,71971
ORD,LGB,JetBlue Airways,1137,40,1100,0,3455,5732
ORD,LIT,American Eagle Airlines Inc.,5965,1300,3269,0,7505,18039
ORD,LNK,Skywest Airlines Inc.,3341,335,1489,0,11569,16734
ORD,LSE,American Eagle Airlines Inc.,3757,1157,2138,0,5262,12314
ORD,MBS,Skywest Airlines Inc.,752,56,247,0,2668,3723
ORD,MCI,American Airlines Inc.,4385,1409,2532,0,7955,16281
ORD,MCI,Skywest Airlines Inc.,240,91,47,0,222,600
ORD,MCI,United Air Lines Inc.,3752,1322,1509,0,9443,16026
ORD,MCO,American Airlines Inc.,3811,1196,3009,0,8878,16894
ORD,MCO,United Air Lines Inc.,8190,1451,3333,0,11014,23988
ORD,MDT,American Eagle Airlines Inc.,2224,397,1579,0,5623,9823
ORD,MDT,United Air Lines Inc.,1864,350,335,0,5599,8148
ORD,MEM,American Eagle Airlines Inc.,4181,1072,3695,0,5036,13984
ORD,MEM,Skywest Airlines Inc.,2926,1524,882,0,9600,14932
ORD,MHT,United Air Lines Inc.,2881,413,727,0,6211,10232
ORD,MIA,American Airlines Inc.,14276,4417,5272,0,13459,37424
ORD,MKE,American Eagle Airlines Inc.,5480,906,4137,0,8078,18601
ORD,MKE,Skywest Airlines Inc.,1681,28,538,0,7066,9313
ORD,MLI,American Eagle Airlines Inc.,3257,1019,1979,0,5374,11629
ORD,MLI,Skywest Airlines Inc.,1374,0,208,0,5160,6742
ORD,MOB,American Eagle Airlines Inc.,714,338,539,0,840,2431
ORD,MQT,American Eagle Airlines Inc.,1622,732,680,0,2896,5930
ORD,MSN,American Eagle Airlines Inc.,5841,1271,3281,0,7481,17874
ORD,MSN,Skywest Airlines Inc.,2663,382,857,50,7413,11365
ORD,MSO,Skywest Airlines Inc.,26,0,84,0,34,144
ORD,MSP,American Airlines Inc.,5105,2028,3606,0,12868,23607
ORD,MSP,United Air Lines Inc.,12528,2445,4884,0,28656,48513
ORD,MSY,American Airlines Inc.,3131,1011,1726,0,5372,11240
ORD,MSY,United Air Lines Inc.,3916,465,1020,0,7617,13018
ORD,MTJ,American Airlines Inc.,90,26,28,0,0,144
ORD,OAK,United Air Lines Inc.,560,65,161,0,1165,1951
ORD,OGG,United Air Lines Inc.,728,81,281,0,0,1090
ORD,OKC,American Eagle Airlines Inc.,4464,1343,4096,0,6805,16708
ORD,OKC,Skywest Airlines Inc.,953,191,327,0,3374,4845
ORD,OMA,American Eagle Airlines Inc.,6187,1488,4580,0,7118,19373
ORD,OMA,Skywest Airlines Inc.,1496,0,132,0,1767,3395
ORD,OMA,United Air Lines Inc.,5239,729,1810,0,11728,19506
ORD,ORF,Skywest Airlines Inc.,1965,110,596,0,5462,8133
ORD,PBI,American Airlines Inc.,2228,508,903,0,2995,6634
ORD,PBI,United Air Lines Inc.,2016,447,1055,0,4491,8009
ORD,PDX,American Airlines Inc.,190,90,517,0,555,1352
ORD,PDX,United Air Lines Inc.,8783,1790,2536,0,11094,24203
ORD,PHL,American Airlines Inc.,4062,1190,5108,0,7703,18063
ORD,PHL,US Airways Inc.,2460,338,5660,15,11653,20126
ORD,PHL,United Air Lines Inc.,8213,1715,9027,0,19084,38039
ORD,PHX,American Airlines Inc.,5178,1989,2807,0,7605,17579
ORD,PHX,US Airways Inc.,6011,441,2147,0,7755,16354
ORD,PHX,United Air Lines Inc.,5595,808,1933,0,6646,14982
ORD,PIA,American Eagle Airlines Inc.,3587,1262,2163,0,5965,12977
ORD,PIA,Skywest Airlines Inc.,3168,325,942,0,9992,14427
ORD,PIT,American Eagle Airlines Inc.,3981,1281,2341,0,6517,14120
ORD,PIT,Skywest Airlines Inc.,958,37,43,0,3873,4911
ORD,PIT,United Air Lines Inc.,4963,637,1628,0,13368,20596
ORD,PNS,American Eagle Airlines Inc.,1349,344,916,0,838,3447
ORD,PSP,American Airlines Inc.,2163,805,1291,0,2953,7212
ORD,PSP,United Air Lines Inc.,263,53,194,0,379,889
ORD,PVD,American Eagle Airlines Inc.,4022,569,1798,0,3635,10024
ORD,PVD,Skywest Airlines Inc.,0,0,0,0,24,24
ORD,PVD,United Air Lines Inc.,2545,188,1132,0,6821,10686
ORD,RAP,Skywest Airlines Inc.,295,0,45,0,651,991
ORD,RAP,United Air Lines Inc.,73,14,185,0,87,359
ORD,RDU,American Airlines Inc.,4516,1146,2452,0,12466,20580
ORD,RDU,United Air Lines Inc.,2461,753,1147,0,5941,10302
ORD,RIC,American Eagle Airlines Inc.,3784,1088,1871,0,5528,12271
ORD,RIC,United Air Lines Inc.,2803,560,1150,0,5992,10505
ORD,RNO,American Airlines Inc.,2180,356,1006,0,1369,4911
ORD,ROA,Skywest Airlines Inc.,502,0,43,0,1331,1876
ORD,ROC,American Eagle Airlines Inc.,3924,1177,1884,0,5025,12010
ORD,ROC,United Air Lines Inc.,1929,184,518,0,4645,7276
ORD,RST,American Eagle Airlines Inc.,5863,1278,3775,0,8979,19895
ORD,RSW,American Airlines Inc.,2290,982,1269,0,3920,8461
ORD,SAN,American Airlines Inc.,4348,1123,2500,0,5620,13591
ORD,SAN,United Air Lines Inc.,6029,950,3890,0,12217,23086
ORD,SAT,American Airlines Inc.,4296,789,2438,0,5370,12893
ORD,SAT,Skywest Airlines Inc.,1170,454,578,0,3621,5823
ORD,SAT,United Air Lines Inc.,410,0,140,0,1024,1574
ORD,SAV,Skywest Airlines Inc.,1333,349,209,0,6536,8427
ORD,SBN,Skywest Airlines Inc.,1251,15,368,0,4042,5676
ORD,SDF,American Eagle Airlines Inc.,4359,1373,3280,0,6442,15454
ORD,SDF,Skywest Airlines Inc.,4347,427,1334,0,14489,20597
ORD,SEA,Alaska Airlines Inc.,2239,49,860,35,6779,9962
ORD,SEA,American Airlines Inc.,4171,1354,2964,0,7850,16339
ORD,SEA,United Air Lines Inc.,8347,1107,2896,0,11101,23451
ORD,SFO,American Airlines Inc.,5527,1299,8833,0,4901,20560
ORD,SFO,Skywest Airlines Inc.,51,0,16,0,0,67
ORD,SFO,United Air Lines Inc.,12574,1938,8997,0,13516,37025
ORD,SGF,American Eagle Airlines Inc.,4750,859,2671,0,6091,14371
ORD,SGF,Skywest Airlines Inc.,2353,529,813,0,12050,15745
ORD,SHV,American Eagle Airlines Inc.,1059,334,630,0,378,2401
ORD,SJC,American Airlines Inc.,4370,955,2091,0,3420,10836
ORD,SJC,United Air Lines Inc.,2478,428,1529,0,5830,10265
ORD,SJU,American Airlines Inc.,1628,863,760,0,762,4013
ORD,SJU,United Air Lines Inc.,1577,89,450,0,1007,3123
ORD,SLC,American Airlines Inc.,2009,739,1884,0,2669,7301
ORD,SLC,Delta Air Lines Inc.,836,194,1450,0,751,3231
ORD,SLC,Skywest Airlines Inc.,1995,401,1452,0,6988,10836
ORD,SLC,United Air Lines Inc.,3034,635,1548,0,6228,11445
ORD,SMF,United Air Lines Inc.,5010,863,2711,0,7058,15642
ORD,SNA,American Airlines Inc.,5204,1154,3229,0,6413,16000
ORD,SNA,United Air Lines Inc.,2742,504,2062,0,5347,10655
ORD,SPI,Skywest Airlines Inc.,445,97,123,0,3988,4653
ORD,STL,American Airlines Inc.,8034,2564,4780,0,17649,33027
ORD,STL,United Air Lines Inc.,1735,180,290,0,1986,4191
ORD,STT,United Air Lines Inc.,503,57,119,0,16,695
ORD,SYR,American Eagle Airlines Inc.,3103,1228,2702,0,5103,12136
ORD,SYR,Skywest Airlines Inc.,1027,176,278,0,1466,2947
ORD,TOL,American Eagle Airlines Inc.,2957,610,1925,0,4908,10400
ORD,TPA,American Airlines Inc.,2785,743,2299,0,7625,13452
ORD,TPA,United Air Lines Inc.,5792,1100,2096,0,10537,19525
ORD,TUL,American Airlines Inc.,2581,859,1827,0,7762,13029
ORD,TUL,American Eagle Airlines Inc.,553,83,440,0,43,1119
ORD,TUL,Skywest Airlines Inc.,1711,112,666,0,6813,9302
ORD,TUS,American Airlines Inc.,2570,855,2080,0,5395,10900
ORD,TVC,American Eagle Airlines Inc.,3419,346,1703,0,3722,9190
ORD,TVC,Skywest Airlines Inc.,1908,0,245,0,6434,8587
ORD,TYS,American Eagle Airlines Inc.,2659,498,2654,0,4595,10406
ORD,TYS,Skywest Airlines Inc.,1248,104,467,0,3321,5140
ORD,VPS,American Eagle Airlines Inc.,688,354,866,0,820,2728
ORD,XNA,American Eagle Airlines Inc.,8103,1438,4237,0,10451,24229
ORD,XNA,Skywest Airlines Inc.,1679,328,569,0,5268,7844
ORF,ATL,Atlantic Southeast Airlines,2354,402,1501,11,1636,5904
ORF,ATL,Delta Air Lines Inc.,1351,0,1965,0,1237,4553
ORF,BNA,Southwest Airlines Co.,30,0,0,0,0,30
ORF,BOI,Skywest Airlines Inc.,0,180,0,0,0,180
ORF,BWI,Southwest Airlines Co.,696,680,662,6,3846,5890
ORF,CLT,US Airways Inc.,928,6,343,0,1511,2788
ORF,CVG,Atlantic Southeast Airlines,0,64,0,0,0,64
ORF,DFW,American Airlines Inc.,1484,34,321,0,971,2810
ORF,DFW,American Eagle Airlines Inc.,508,141,714,0,3007,4370
ORF,JAX,Southwest Airlines Co.,320,128,70,0,1431,1949
ORF,LAS,Southwest Airlines Co.,549,0,356,0,46,951
ORF,MCO,Southwest Airlines Co.,211,45,192,0,2812,3260
ORF,MDW,Southwest Airlines Co.,797,555,397,4,2787,4540
ORF,MIA,American Eagle Airlines Inc.,132,64,219,0,1797,2212
ORF,ORD,Skywest Airlines Inc.,1094,10,2647,34,1024,4809
ORF,TPA,Southwest Airlines Co.,413,37,152,0,1058,1660
OTZ,ANC,Alaska Airlines Inc.,55,109,111,53,943,1271
OTZ,OME,Alaska Airlines Inc.,329,340,62,51,1019,1801
OXR,LAX,Skywest Airlines Inc.,642,79,313,0,1025,2059
PBI,ATL,Delta Air Lines Inc.,3316,250,3040,0,4566,11172
PBI,BDL,Delta Air Lines Inc.,454,0,93,0,1984,2531
PBI,BOS,Delta Air Lines Inc.,357,87,765,0,3139,4348
PBI,BOS,JetBlue Airways,354,22,2164,1,1755,4296
PBI,BWI,Southwest Airlines Co.,869,394,362,0,4055,5680
PBI,CLT,US Airways Inc.,715,72,495,0,1930,3212
PBI,DCA,US Airways Inc.,889,0,915,0,2135,3939
PBI,DEN,Frontier Airlines Inc.,18,0,54,0,63,135
PBI,DFW,American Airlines Inc.,1490,65,1198,0,1918,4671
PBI,EWR,JetBlue Airways,236,0,5070,0,1150,6456
PBI,HPN,JetBlue Airways,203,0,305,0,1055,1563
PBI,ISP,Southwest Airlines Co.,797,89,473,0,5630,6989
PBI,JFK,JetBlue Airways,2156,0,7709,0,11712,21577
PBI,LAS,US Airways Inc.,96,0,119,0,122,337
PBI,LGA,American Airlines Inc.,106,0,1445,0,699,2250
PBI,LGA,Delta Air Lines Inc.,971,58,4052,0,3504,8585
PBI,LGA,JetBlue Airways,530,0,7737,0,1798,10065
PBI,ORD,American Airlines Inc.,854,0,3270,0,2471,6595
PBI,ORD,United Air Lines Inc.,3952,0,344,0,636,4932
PBI,PHL,Southwest Airlines Co.,474,425,2931,0,1171,5001
PBI,PHL,US Airways Inc.,789,0,2221,0,1459,4469
PBI,SWF,JetBlue Airways,271,0,29,0,260,560
PBI,TPA,Southwest Airlines Co.,670,110,604,0,2457,3841
PDX,ABQ,Southwest Airlines Co.,424,40,34,0,114,612
PDX,ANC,Alaska Airlines Inc.,692,27,321,0,184,1224
PDX,ATL,Delta Air Lines Inc.,1045,131,394,0,842,2412
PDX,BOI,Southwest Airlines Co.,1436,199,133,65,3124,4957
PDX,BOS,Alaska Airlines Inc.,1345,0,200,0,0,1545
PDX,BUR,Alaska Airlines Inc.,0,0,0,0,64,64
PDX,CLT,US Airways Inc.,107,0,11,0,234,352
PDX,CVG,Delta Air Lines Inc.,58,0,52,0,544,654
PDX,DEN,Alaska Airlines Inc.,763,0,269,0,603,1635
PDX,DEN,Frontier Airlines Inc.,1294,55,2100,0,2325,5774
PDX,DEN,Southwest Airlines Co.,118,0,45,13,60,236
PDX,DEN,United Air Lines Inc.,2218,23,674,0,7734,10649
PDX,DFW,American Airlines Inc.,3985,114,731,0,2148,6978
PDX,EUG,Skywest Airlines Inc.,835,392,11,0,333,1571
PDX,GEG,Southwest Airlines Co.,1240,173,256,17,4973,6659
PDX,HNL,Hawaiian Airlines Inc.,243,6,0,1,82,332
PDX,IAD,United Air Lines Inc.,1301,151,105,0,211,1768
PDX,JFK,Delta Air Lines Inc.,104,0,7,0,128,239
PDX,JFK,JetBlue Airways,220,0,130,0,796,1146
PDX,LAS,Alaska Airlines Inc.,2217,0,661,0,1413,4291
PDX,LAS,Southwest Airlines Co.,1817,342,864,37,3989,7049
PDX,LAS,US Airways Inc.,866,0,544,0,1589,2999
PDX,LAX,Alaska Airlines Inc.,1606,132,308,0,1404,3450
PDX,LAX,Skywest Airlines Inc.,2994,50,328,0,2015,5387
PDX,LAX,United Air Lines Inc.,54,0,91,0,362,507
PDX,MCI,Southwest Airlines Co.,168,60,76,13,395,712
PDX,MCO,Alaska Airlines Inc.,923,0,92,0,34,1049
PDX,MDW,Southwest Airlines Co.,1002,58,706,0,1062,2828
PDX,MFR,Skywest Airlines Inc.,841,166,28,0,704,1739
PDX,OAK,Alaska Airlines Inc.,1260,0,173,31,1451,2915
PDX,OAK,Southwest Airlines Co.,2527,27,213,46,6474,9287
PDX,OGG,Hawaiian Airlines Inc.,886,0,0,0,7,893
PDX,ONT,Alaska Airlines Inc.,401,0,135,0,649,1185
PDX,ORD,American Airlines Inc.,1038,39,757,0,30,1864
PDX,ORD,United Air Lines Inc.,2076,0,4464,0,5925,12465
PDX,PHL,US Airways Inc.,190,0,438,0,219,847
PDX,PHX,Alaska Airlines Inc.,1129,0,227,2,1163,2521
PDX,PHX,Southwest Airlines Co.,1187,0,200,37,2267,3691
PDX,PHX,US Airways Inc.,2531,0,197,0,1529,4257
PDX,PSP,Alaska Airlines Inc.,605,0,65,0,550,1220
PDX,RDM,Skywest Airlines Inc.,1830,0,1,15,288,2134
PDX,RNO,Southwest Airlines Co.,1487,145,211,8,3538,5389
PDX,SAN,Alaska Airlines Inc.,1410,25,387,0,1894,3716
PDX,SEA,Skywest Airlines Inc.,1781,431,1309,0,963,4484
PDX,SFO,Alaska Airlines Inc.,595,0,3671,0,1023,5289
PDX,SFO,United Air Lines Inc.,1324,21,8782,0,8493,18620
PDX,SJC,Alaska Airlines Inc.,1197,74,232,0,2002,3505
PDX,SJC,Southwest Airlines Co.,1430,92,113,0,2659,4294
PDX,SLC,Delta Air Lines Inc.,873,262,118,0,700,1953
PDX,SLC,Skywest Airlines Inc.,564,231,17,0,1727,2539
PDX,SLC,Southwest Airlines Co.,1316,86,359,0,2391,4152
PDX,SMF,Alaska Airlines Inc.,248,0,67,0,1177,1492
PDX,SMF,Southwest Airlines Co.,2030,167,172,83,7833,10285
PDX,SNA,Alaska Airlines Inc.,1661,0,313,0,1934,3908
PFN,ATL,Atlantic Southeast Airlines,8445,3791,3913,0,709,16858
PFN,MCO,Atlantic Southeast Airlines,505,104,20,0,12,641
PHF,ATL,Atlantic Southeast Airlines,6066,1607,2796,1,649,11119
PHF,ATL,Delta Air Lines Inc.,355,61,289,0,439,1144
PHL,ALB,US Airways Inc.,463,147,278,0,1578,2466
PHL,ATL,Atlantic Southeast Airlines,406,126,118,0,25,675
PHL,ATL,Delta Air Lines Inc.,4768,203,3964,0,6766,15701
PHL,ATL,US Airways Inc.,1780,0,732,0,2728,5240
PHL,AUS,Southwest Airlines Co.,478,0,244,0,1813,2535
PHL,BDL,US Airways Inc.,724,110,361,0,1903,3098
PHL,BNA,Southwest Airlines Co.,831,6,982,12,5987,7818
PHL,BOS,US Airways Inc.,5666,295,4616,118,8641,19336
PHL,BUF,US Airways Inc.,826,89,290,19,1253,2477
PHL,BWI,US Airways Inc.,849,30,730,0,3282,4891
PHL,CLT,US Airways Inc.,6493,199,4695,78,6946,18411
PHL,CMH,Southwest Airlines Co.,785,78,460,34,5494,6851
PHL,CVG,Atlantic Southeast Airlines,739,128,199,0,154,1220
PHL,CVG,Skywest Airlines Inc.,10,0,32,0,44,86
PHL,DCA,US Airways Inc.,761,30,815,0,1098,2704
PHL,DEN,Frontier Airlines Inc.,966,645,862,0,1145,3618
PHL,DEN,Southwest Airlines Co.,140,0,125,0,600,865
PHL,DEN,US Airways Inc.,1938,166,1262,91,1662,5119
PHL,DEN,United Air Lines Inc.,2419,398,1601,0,5763,10181
PHL,DFW,American Airlines Inc.,4363,289,4055,0,9667,18374
PHL,DFW,US Airways Inc.,2114,188,1219,0,1612,5133
PHL,DTW,US Airways Inc.,325,95,371,0,976,1767
PHL,FLL,Southwest Airlines Co.,962,64,783,5,6462,8276
PHL,FLL,US Airways Inc.,3950,64,2005,5,6590,12614
PHL,HOU,Southwest Airlines Co.,1060,45,899,0,4613,6617
PHL,IND,US Airways Inc.,355,89,636,0,1528,2608
PHL,JAX,Southwest Airlines Co.,731,5,829,8,5175,6748
PHL,JAX,US Airways Inc.,1518,40,904,81,3440,5983
PHL,LAS,Southwest Airlines Co.,937,303,822,4,2723,4789
PHL,LAS,US Airways Inc.,6605,287,3482,59,6123,16556
PHL,LAX,US Airways Inc.,3709,44,2677,9,3953,10392
PHL,LAX,United Air Lines Inc.,2344,239,1212,0,2344,6139
PHL,MCO,Southwest Airlines Co.,2187,708,2279,16,13359,18549
PHL,MCO,US Airways Inc.,6841,229,3332,118,8950,19470
PHL,MDW,Southwest Airlines Co.,2431,1241,2863,38,12143,18716
PHL,MHT,Southwest Airlines Co.,2108,89,1320,0,12957,16474
PHL,MHT,US Airways Inc.,708,107,281,0,2038,3134
PHL,MIA,American Airlines Inc.,2666,121,2069,70,6714,11640
PHL,MIA,US Airways Inc.,1934,81,1910,42,3351,7318
PHL,MKE,Skywest Airlines Inc.,1896,107,2808,0,115,4926
PHL,MSY,US Airways Inc.,1590,0,958,13,2398,4959
PHL,ORD,American Airlines Inc.,1589,712,7222,0,9670,19193
PHL,ORD,US Airways Inc.,3337,970,14903,43,5680,24933
PHL,ORD,United Air Lines Inc.,6615,921,13965,0,14589,36090
PHL,ORF,US Airways Inc.,402,0,42,0,313,757
PHL,PBI,Southwest Airlines Co.,1201,0,1006,0,4037,6244
PHL,PBI,US Airways Inc.,1663,102,1128,0,4286,7179
PHL,PDX,US Airways Inc.,643,26,744,22,686,2121
PHL,PHX,Southwest Airlines Co.,876,6,1053,7,2939,4881
PHL,PHX,US Airways Inc.,5112,80,3027,75,4136,12430
PHL,PIT,Southwest Airlines Co.,2898,445,2270,12,17063,22688
PHL,PIT,US Airways Inc.,1213,117,772,13,1948,4063
PHL,PVD,Southwest Airlines Co.,1650,186,761,18,10149,12764
PHL,PVD,US Airways Inc.,1618,304,304,0,2980,5206
PHL,RDU,Southwest Airlines Co.,2460,17,1485,2,11427,15391
PHL,RDU,US Airways Inc.,1504,38,488,0,1741,3771
PHL,RIC,US Airways Inc.,901,61,587,0,1691,3240
PHL,RSW,Southwest Airlines Co.,344,62,188,0,1501,2095
PHL,RSW,US Airways Inc.,1694,18,1240,0,2835,5787
PHL,SAN,US Airways Inc.,1495,79,1531,13,1246,4364
PHL,SAT,Southwest Airlines Co.,40,0,113,0,305,458
PHL,SEA,US Airways Inc.,1301,86,1063,32,2382,4864
PHL,SFO,US Airways Inc.,2707,53,4998,42,4040,11840
PHL,SFO,United Air Lines Inc.,1291,366,1227,0,3450,6334
PHL,SJU,American Airlines Inc.,540,0,78,0,0,618
PHL,SJU,US Airways Inc.,5718,121,1549,61,5006,12455
PHL,SLC,Delta Air Lines Inc.,901,35,382,0,1727,3045
PHL,SMF,US Airways Inc.,83,0,540,0,236,859
PHL,STL,Southwest Airlines Co.,273,4,183,0,2129,2589
PHL,STT,US Airways Inc.,1567,0,468,0,1253,3288
PHL,SYR,US Airways Inc.,541,34,580,0,1542,2697
PHL,TPA,Southwest Airlines Co.,1253,115,1132,14,10004,12518
PHL,TPA,US Airways Inc.,3216,0,1967,42,5187,10412
PHX,ABQ,Southwest Airlines Co.,4485,4,546,47,6394,11476
PHX,ABQ,US Airways Inc.,2157,33,267,24,1375,3856
PHX,ANC,US Airways Inc.,698,0,419,0,267,1384
PHX,ATL,Delta Air Lines Inc.,2338,0,911,0,2514,5763
PHX,ATL,US Airways Inc.,2783,59,917,48,1461,5268
PHX,AUS,Southwest Airlines Co.,1501,0,109,29,2820,4459
PHX,AUS,US Airways Inc.,845,0,204,0,891,1940
PHX,BDL,US Airways Inc.,504,0,255,0,515,1274
PHX,BHM,Southwest Airlines Co.,672,0,66,19,791,1548
PHX,BNA,Southwest Airlines Co.,1168,73,109,0,2690,4040
PHX,BOI,US Airways Inc.,983,0,148,0,732,1863
PHX,BOS,US Airways Inc.,1500,0,939,0,1711,4150
PHX,BUF,Southwest Airlines Co.,382,23,85,0,106,596
PHX,BUR,Southwest Airlines Co.,2656,20,1075,15,10865,14631
PHX,BUR,US Airways Inc.,1268,0,211,0,1043,2522
PHX,BWI,Southwest Airlines Co.,1185,353,538,29,2280,4385
PHX,BWI,US Airways Inc.,770,0,1074,0,576,2420
PHX,CLE,US Airways Inc.,766,0,20,0,537,1323
PHX,CLT,US Airways Inc.,5710,199,900,74,3745,10628
PHX,CMH,Southwest Airlines Co.,274,0,60,0,681,1015
PHX,CMH,US Airways Inc.,1377,0,312,0,1077,2766
PHX,CVG,Delta Air Lines Inc.,199,305,112,0,1069,1685
PHX,DCA,US Airways Inc.,2334,0,1399,24,1354,5111
PHX,DEN,Frontier Airlines Inc.,2220,15,2763,0,2250,7248
PHX,DEN,Southwest Airlines Co.,3324,45,623,45,5046,9083
PHX,DEN,US Airways Inc.,1906,0,315,42,903,3166
PHX,DEN,United Air Lines Inc.,3003,24,1090,0,7548,11665
PHX,DFW,American Airlines Inc.,2827,93,3292,7,9153,15372
PHX,DFW,US Airways Inc.,2915,11,1087,0,1726,5739
PHX,DTW,Southwest Airlines Co.,621,0,142,0,447,1210
PHX,DTW,US Airways Inc.,1329,0,223,22,1260,2834
PHX,ELP,Southwest Airlines Co.,3514,0,448,60,6156,10178
PHX,ELP,US Airways Inc.,574,0,42,18,530,1164
PHX,EWR,US Airways Inc.,1225,0,8699,0,1372,11296
PHX,FLL,US Airways Inc.,1690,0,308,18,1035,3051
PHX,GEG,US Airways Inc.,1286,0,225,0,1387,2898
PHX,HNL,Hawaiian Airlines Inc.,121,0,0,14,275,410
PHX,HNL,US Airways Inc.,4776,0,309,0,1251,6336
PHX,HOU,Southwest Airlines Co.,2020,76,604,40,3368,6108
PHX,IAD,US Airways Inc.,381,0,83,26,416,906
PHX,IAD,United Air Lines Inc.,1602,0,208,0,18,1828
PHX,IAH,US Airways Inc.,1229,0,523,0,831,2583
PHX,IND,Southwest Airlines Co.,1513,0,279,16,1718,3526
PHX,IND,US Airways Inc.,1114,0,111,0,998,2223
PHX,JFK,Delta Air Lines Inc.,348,0,832,0,1249,2429
PHX,JFK,JetBlue Airways,191,0,1874,0,2331,4396
PHX,JFK,US Airways Inc.,2518,0,2162,21,1503,6204
PHX,KOA,US Airways Inc.,1719,0,167,33,407,2326
PHX,LAS,Southwest Airlines Co.,8929,1735,7065,88,17984,35801
PHX,LAS,US Airways Inc.,8114,181,4754,89,6760,19898
PHX,LAX,Skywest Airlines Inc.,587,17,746,0,3905,5255
PHX,LAX,Southwest Airlines Co.,5235,167,3617,81,14791,23891
PHX,LAX,US Airways Inc.,3954,4,1344,85,4204,9591
PHX,LIH,US Airways Inc.,1232,0,129,0,771,2132
PHX,LIT,Southwest Airlines Co.,847,0,47,14,1572,2480
PHX,MCI,Southwest Airlines Co.,1210,50,153,35,2188,3636
PHX,MCI,US Airways Inc.,2241,0,274,31,1366,3912
PHX,MCO,Southwest Airlines Co.,396,2,51,0,312,761
PHX,MCO,US Airways Inc.,1123,0,72,20,684,1899
PHX,MDW,Southwest Airlines Co.,2781,559,781,7,3488,7616
PHX,MHT,Southwest Airlines Co.,276,274,277,0,372,1199
PHX,MIA,American Airlines Inc.,365,0,19,0,0,384
PHX,MKE,US Airways Inc.,1210,0,148,0,755,2113
PHX,MSP,US Airways Inc.,2304,0,1030,0,1457,4791
PHX,MSY,Southwest Airlines Co.,361,11,56,0,687,1115
PHX,OAK,Southwest Airlines Co.,3029,2,790,1,8312,12134
PHX,OAK,US Airways Inc.,1943,0,624,2,2600,5169
PHX,OGG,US Airways Inc.,5684,0,273,12,1411,7380
PHX,OKC,Southwest Airlines Co.,1308,0,66,8,2342,3724
PHX,OMA,Southwest Airlines Co.,1421,0,375,8,3585,5389
PHX,OMA,US Airways Inc.,1285,0,143,0,780,2208
PHX,ONT,Southwest Airlines Co.,4274,25,1083,103,12773,18258
PHX,ONT,US Airways Inc.,3853,0,582,42,2756,7233
PHX,ORD,American Airlines Inc.,2319,0,10916,0,7670,20905
PHX,ORD,US Airways Inc.,2338,0,15103,20,1575,19036
PHX,ORD,United Air Lines Inc.,1448,0,4583,53,4800,10884
PHX,PDX,Alaska Airlines Inc.,967,0,363,0,1095,2425
PHX,PDX,Southwest Airlines Co.,2130,32,575,0,2666,5403
PHX,PDX,US Airways Inc.,3730,4,1208,20,2728,7690
PHX,PHL,Southwest Airlines Co.,1159,473,1146,0,988,3766
PHX,PHL,US Airways Inc.,5386,0,3439,18,1901,10744
PHX,PIT,Southwest Airlines Co.,254,4,136,0,326,720
PHX,PIT,US Airways Inc.,889,0,395,15,1359,2658
PHX,PVD,Southwest Airlines Co.,331,2,330,0,396,1059
PHX,RDU,Southwest Airlines Co.,305,0,107,21,240,673
PHX,RDU,US Airways Inc.,578,0,120,0,302,1000
PHX,RNO,Southwest Airlines Co.,2405,0,383,49,3124,5961
PHX,RNO,US Airways Inc.,1858,0,554,9,1652,4073
PHX,SAN,Southwest Airlines Co.,5700,156,1945,87,15337,23225
PHX,SAN,US Airways Inc.,3599,0,1267,120,5681,10667
PHX,SAT,Southwest Airlines Co.,2237,0,335,23,2575,5170
PHX,SAT,US Airways Inc.,794,0,63,0,649,1506
PHX,SDF,Southwest Airlines Co.,260,0,28,0,481,769
PHX,SEA,Alaska Airlines Inc.,5385,23,1590,5,4484,11487
PHX,SEA,Southwest Airlines Co.,2370,0,627,30,3673,6700
PHX,SEA,US Airways Inc.,3363,0,961,16,2297,6637
PHX,SFO,Southwest Airlines Co.,1298,343,1894,7,3148,6690
PHX,SFO,US Airways Inc.,3702,126,8301,26,2414,14569
PHX,SFO,United Air Lines Inc.,2431,0,5096,0,6923,14450
PHX,SJC,Southwest Airlines Co.,1346,55,650,38,4381,6470
PHX,SJC,US Airways Inc.,3302,0,675,45,1998,6020
PHX,SLC,Delta Air Lines Inc.,473,94,476,0,1365,2408
PHX,SLC,Skywest Airlines Inc.,521,0,133,0,4896,5550
PHX,SLC,Southwest Airlines Co.,4006,236,1199,80,8480,14001
PHX,SLC,US Airways Inc.,3644,0,1040,8,2397,7089
PHX,SMF,Southwest Airlines Co.,2735,8,781,5,9131,12660
PHX,SMF,US Airways Inc.,2136,25,813,50,2501,5525
PHX,SNA,Southwest Airlines Co.,3011,202,900,49,6087,10249
PHX,SNA,US Airways Inc.,3423,0,404,0,1502,5329
PHX,STL,Southwest Airlines Co.,2397,66,374,14,4308,7159
PHX,STL,US Airways Inc.,1771,0,202,0,801,2774
PHX,TPA,Southwest Airlines Co.,335,0,56,0,189,580
PHX,TPA,US Airways Inc.,915,0,34,0,488,1437
PHX,TUL,Southwest Airlines Co.,807,2,198,7,2724,3738
PHX,TUS,US Airways Inc.,396,0,171,0,295,862
PIA,ATL,Atlantic Southeast Airlines,3823,944,797,4,110,5678
PIA,DEN,Skywest Airlines Inc.,435,57,0,0,19,511
PIA,DFW,American Eagle Airlines Inc.,1460,331,482,0,728,3001
PIA,ORD,American Eagle Airlines Inc.,3702,97,7566,0,8117,19482
PIA,ORD,Skywest Airlines Inc.,1206,170,14057,0,2681,18114
PIH,SLC,Skywest Airlines Inc.,805,682,242,0,1838,3567
PIT,ATL,Atlantic Southeast Airlines,962,278,383,0,71,1694
PIT,ATL,Delta Air Lines Inc.,1428,439,2167,0,3034,7068
PIT,ATL,Skywest Airlines Inc.,307,0,359,0,243,909
PIT,BOS,JetBlue Airways,515,0,707,0,2483,3705
PIT,BOS,US Airways Inc.,0,0,3,0,59,62
PIT,BWI,Southwest Airlines Co.,1154,398,585,23,3441,5601
PIT,CLT,US Airways Inc.,2571,261,989,11,1314,5146
PIT,CVG,Atlantic Southeast Airlines,0,200,16,0,0,216
PIT,CVG,Delta Air Lines Inc.,158,28,81,0,0,267
PIT,DEN,Skywest Airlines Inc.,88,112,34,0,604,838
PIT,DEN,United Air Lines Inc.,3050,301,1259,0,4064,8674
PIT,DFW,American Eagle Airlines Inc.,2862,953,2388,0,9981,16184
PIT,FLL,US Airways Inc.,179,0,171,0,228,578
PIT,JFK,American Eagle Airlines Inc.,105,34,1534,0,1799,3472
PIT,JFK,Atlantic Southeast Airlines,58,321,1364,0,0,1743
PIT,JFK,JetBlue Airways,791,67,2759,8,1839,5464
PIT,LAS,Southwest Airlines Co.,463,81,694,7,1397,2642
PIT,LAS,US Airways Inc.,777,0,327,0,653,1757
PIT,LAX,US Airways Inc.,905,228,743,0,1030,2906
PIT,LGA,American Eagle Airlines Inc.,122,66,4618,0,3575,8381
PIT,LGA,US Airways Inc.,183,0,417,0,235,835
PIT,MCI,Skywest Airlines Inc.,1060,223,56,0,0,1339
PIT,MCO,Southwest Airlines Co.,730,23,899,0,3412,5064
PIT,MCO,US Airways Inc.,803,22,260,0,568,1653
PIT,MDW,Southwest Airlines Co.,1815,718,2512,21,6055,11121
PIT,MIA,American Eagle Airlines Inc.,428,506,162,0,0,1096
PIT,MIA,US Airways Inc.,12,0,24,0,50,86
PIT,MKE,Skywest Airlines Inc.,4357,1413,1433,34,586,7823
PIT,ORD,American Eagle Airlines Inc.,1686,266,6461,0,8181,16594
PIT,ORD,Skywest Airlines Inc.,875,90,2714,0,2022,5701
PIT,ORD,United Air Lines Inc.,2218,431,7686,0,6895,17230
PIT,PHL,Southwest Airlines Co.,1257,2392,5533,30,11024,20236
PIT,PHL,US Airways Inc.,1735,440,5161,0,2455,9791
PIT,PHX,Southwest Airlines Co.,299,37,173,10,955,1474
PIT,PHX,US Airways Inc.,791,178,276,0,657,1902
PIT,RSW,US Airways Inc.,177,0,0,0,0,177
PIT,SFO,US Airways Inc.,131,146,1340,45,542,2204
PIT,SLC,Delta Air Lines Inc.,614,52,719,0,961,2346
PIT,SLC,Skywest Airlines Inc.,50,18,60,0,486,614
PIT,TPA,Southwest Airlines Co.,445,143,254,7,1374,2223
PIT,TPA,US Airways Inc.,982,0,175,0,448,1605
PMD,SFO,Skywest Airlines Inc.,518,0,4391,0,404,5313
PNS,ATL,Atlantic Southeast Airlines,2205,667,1464,0,2166,6502
PNS,ATL,Delta Air Lines Inc.,2121,117,2418,0,3076,7732
PNS,DFW,American Eagle Airlines Inc.,1640,307,2094,0,7805,11846
PNS,FLL,Atlantic Southeast Airlines,44,131,35,0,0,210
PNS,MCO,Atlantic Southeast Airlines,603,456,130,0,187,1376
PNS,ORD,American Eagle Airlines Inc.,814,13,3007,0,3404,7238
PNS,TPA,Atlantic Southeast Airlines,425,0,0,0,61,486
PSC,DEN,Skywest Airlines Inc.,387,313,121,0,861,1682
PSC,SLC,Skywest Airlines Inc.,507,120,5,27,2039,2698
PSE,FLL,JetBlue Airways,0,14,46,8,211,279
PSE,JFK,JetBlue Airways,26,0,81,0,466,573
PSE,MCO,JetBlue Airways,41,0,61,0,909,1011
PSG,JNU,Alaska Airlines Inc.,392,253,181,6,1270,2102
PSG,WRG,Alaska Airlines Inc.,61,41,106,0,1449,1657
PSP,DEN,Skywest Airlines Inc.,917,41,694,0,344,1996
PSP,DEN,United Air Lines Inc.,786,0,158,0,1260,2204
PSP,DFW,American Airlines Inc.,1650,51,491,4,3856,6052
PSP,LAS,Skywest Airlines Inc.,2319,95,867,0,822,4103
PSP,LAX,Skywest Airlines Inc.,8039,717,1254,45,1802,11857
PSP,ORD,American Airlines Inc.,1805,59,4529,0,2643,9036
PSP,ORD,United Air Lines Inc.,135,0,923,0,297,1355
PSP,PDX,Alaska Airlines Inc.,520,0,521,0,1228,2269
PSP,SEA,Alaska Airlines Inc.,1547,0,774,0,2044,4365
PSP,SFO,Alaska Airlines Inc.,808,0,2173,13,4447,7441
PSP,SFO,Skywest Airlines Inc.,1045,0,2882,0,1850,5777
PSP,SLC,Skywest Airlines Inc.,2107,378,689,0,144,3318
PVD,ATL,Atlantic Southeast Airlines,3119,1014,2540,0,657,7330
PVD,BNA,Southwest Airlines Co.,290,0,62,0,301,653
PVD,BWI,Southwest Airlines Co.,2982,1196,3299,20,12048,19545
PVD,CLT,US Airways Inc.,1385,81,969,0,695,3130
PVD,CVG,Atlantic Southeast Airlines,34,0,0,0,0,34
PVD,DCA,US Airways Inc.,118,71,223,0,762,1174
PVD,FLL,Southwest Airlines Co.,84,109,144,13,0,350
PVD,LAS,Southwest Airlines Co.,142,230,225,0,0,597
PVD,MCO,Southwest Airlines Co.,1959,318,1594,0,4574,8445
PVD,MCO,US Airways Inc.,65,0,49,0,139,253
PVD,MDW,Southwest Airlines Co.,1172,936,1707,14,3104,6933
PVD,ORD,American Eagle Airlines Inc.,1294,127,4638,8,4062,10129
PVD,ORD,United Air Lines Inc.,906,434,4578,0,2626,8544
PVD,PHL,Southwest Airlines Co.,1150,856,7252,4,7392,16654
PVD,PHL,US Airways Inc.,505,0,3434,0,1011,4950
PVD,PHX,Southwest Airlines Co.,156,34,341,0,859,1390
PVD,TPA,Southwest Airlines Co.,793,260,866,0,1920,3839
PWM,ATL,Atlantic Southeast Airlines,2481,1458,2026,0,983,6948
PWM,JFK,JetBlue Airways,3267,0,4661,0,1629,9557
PWM,MCO,JetBlue Airways,277,0,122,12,401,812
RAP,DEN,Skywest Airlines Inc.,430,171,729,0,2246,3576
RAP,ORD,Skywest Airlines Inc.,23,0,718,0,569,1310
RAP,ORD,United Air Lines Inc.,0,0,626,0,307,933
RAP,SLC,Skywest Airlines Inc.,724,180,83,0,513,1500
RDD,SFO,Skywest Airlines Inc.,962,39,12396,187,3314,16898
RDD,SMF,Skywest Airlines Inc.,0,41,0,0,0,41
RDM,PDX,Skywest Airlines Inc.,2686,565,169,0,859,4279
RDM,SFO,Skywest Airlines Inc.,2413,268,8187,0,1271,12139
RDM,SLC,Skywest Airlines Inc.,576,21,12,0,752,1361
RDU,ATL,Atlantic Southeast Airlines,768,316,378,0,172,1634
RDU,ATL,Delta Air Lines Inc.,3057,97,2898,0,2117,8169
RDU,AUS,American Airlines Inc.,240,131,491,0,3497,4359
RDU,BDL,American Eagle Airlines Inc.,1760,299,608,0,2592,5259
RDU,BNA,Southwest Airlines Co.,1109,66,601,6,8910,10692
RDU,BOS,American Eagle Airlines Inc.,3119,340,3683,0,6867,14009
RDU,BOS,JetBlue Airways,31,0,452,0,1280,1763
RDU,BWI,Southwest Airlines Co.,1333,774,1148,0,6479,9734
RDU,CLT,US Airways Inc.,1940,160,1989,25,3017,7131
RDU,CMH,American Eagle Airlines Inc.,1314,241,331,0,1749,3635
RDU,CVG,Delta Air Lines Inc.,211,0,126,0,0,337
RDU,DCA,American Eagle Airlines Inc.,4177,427,1168,0,4774,10546
RDU,DEN,Southwest Airlines Co.,25,0,45,0,234,304
RDU,DEN,United Air Lines Inc.,373,329,425,0,1476,2603
RDU,DFW,American Airlines Inc.,2334,375,1808,0,5521,10038
RDU,EWR,American Eagle Airlines Inc.,679,31,7171,0,2652,10533
RDU,FLL,JetBlue Airways,44,0,100,0,813,957
RDU,FLL,Southwest Airlines Co.,65,105,61,0,178,409
RDU,IAD,United Air Lines Inc.,1104,7,988,0,3097,5196
RDU,JAX,American Eagle Airlines Inc.,3072,438,510,0,1901,5921
RDU,JFK,American Eagle Airlines Inc.,2062,336,4533,0,2945,9876
RDU,JFK,JetBlue Airways,917,0,5509,1,2805,9232
RDU,LAS,Southwest Airlines Co.,417,94,1297,0,2353,4161
RDU,LGA,American Airlines Inc.,945,67,5824,0,886,7722
RDU,LGA,American Eagle Airlines Inc.,2753,205,11414,0,5400,19772
RDU,MCI,American Eagle Airlines Inc.,1412,62,491,0,543,2508
RDU,MCO,Atlantic Southeast Airlines,200,144,114,0,0,458
RDU,MCO,Southwest Airlines Co.,1098,44,523,6,4787,6458
RDU,MDW,Southwest Airlines Co.,1273,426,1088,8,3878,6673
RDU,MIA,American Airlines Inc.,1294,370,1129,6,4424,7223
RDU,MKE,Skywest Airlines Inc.,2215,884,526,32,422,4079
RDU,ORD,American Airlines Inc.,1713,8,4687,0,5002,11410
RDU,ORD,United Air Lines Inc.,939,204,4584,0,2680,8407
RDU,PHL,Southwest Airlines Co.,1265,1067,8333,0,4678,15343
RDU,PHL,US Airways Inc.,664,10,5645,0,2055,8374
RDU,PHX,Southwest Airlines Co.,384,0,181,0,880,1445
RDU,PHX,US Airways Inc.,268,136,90,0,526,1020
RDU,SDF,American Eagle Airlines Inc.,842,172,447,0,1257,2718
RDU,SLC,Delta Air Lines Inc.,865,0,45,0,121,1031
RDU,STL,American Airlines Inc.,191,213,220,0,459,1083
RDU,TPA,Southwest Airlines Co.,764,26,195,6,1659,2650
RDU,XNA,American Eagle Airlines Inc.,865,101,147,0,1200,2313
RFD,DEN,Skywest Airlines Inc.,1360,0,25,0,815,2200
RIC,ATL,Atlantic Southeast Airlines,2044,479,1032,0,553,4108
RIC,ATL,Delta Air Lines Inc.,1846,188,2764,0,1889,6687
RIC,BOS,JetBlue Airways,777,332,1462,0,1540,4111
RIC,CLT,US Airways Inc.,755,7,499,0,334,1595
RIC,DFW,American Airlines Inc.,1742,212,783,0,2718,5455
RIC,FLL,JetBlue Airways,436,0,444,0,1008,1888
RIC,JFK,JetBlue Airways,1595,126,2397,0,2578,6696
RIC,MCO,Atlantic Southeast Airlines,120,166,0,0,0,286
RIC,MIA,American Eagle Airlines Inc.,603,6,539,0,2057,3205
RIC,ORD,American Eagle Airlines Inc.,1716,301,6749,0,5584,14350
RIC,ORD,United Air Lines Inc.,2273,258,3475,0,1863,7869
RIC,ORF,Skywest Airlines Inc.,0,0,227,0,0,227
RIC,PHL,US Airways Inc.,339,0,1221,0,134,1694
RNO,ATL,Delta Air Lines Inc.,801,207,292,0,0,1300
RNO,BOI,Southwest Airlines Co.,1031,8,103,3,3066,4211
RNO,DEN,United Air Lines Inc.,1288,256,352,0,3609,5505
RNO,DFW,American Airlines Inc.,898,326,411,0,4188,5823
RNO,LAS,Southwest Airlines Co.,2702,571,3381,34,13875,20563
RNO,LAS,US Airways Inc.,207,0,46,0,380,633
RNO,LAX,Skywest Airlines Inc.,659,28,486,0,2544,3717
RNO,LAX,Southwest Airlines Co.,839,248,579,0,2900,4566
RNO,MDW,Southwest Airlines Co.,57,142,90,0,295,584
RNO,OAK,Southwest Airlines Co.,820,72,609,0,3391,4892
RNO,ONT,Southwest Airlines Co.,22,0,0,0,44,66
RNO,ORD,American Airlines Inc.,293,44,2757,0,3447,6541
RNO,PDX,Southwest Airlines Co.,818,39,311,0,4049,5217
RNO,PHX,Southwest Airlines Co.,506,305,401,0,3651,4863
RNO,PHX,US Airways Inc.,1845,62,288,0,1899,4094
RNO,SAN,Southwest Airlines Co.,466,0,120,5,2279,2870
RNO,SEA,Alaska Airlines Inc.,100,0,143,0,512,755
RNO,SEA,Southwest Airlines Co.,222,0,135,0,1322,1679
RNO,SFO,Skywest Airlines Inc.,1427,724,9273,0,4519,15943
RNO,SFO,United Air Lines Inc.,563,102,1665,0,2310,4640
RNO,SJC,Southwest Airlines Co.,1147,235,236,8,4333,5959
RNO,SLC,Delta Air Lines Inc.,123,82,88,0,348,641
RNO,SLC,Skywest Airlines Inc.,730,121,0,0,1090,1941
RNO,SLC,Southwest Airlines Co.,127,51,129,0,888,1195
ROA,ATL,Atlantic Southeast Airlines,2569,1523,2662,14,381,7149
ROA,ORD,Skywest Airlines Inc.,366,181,5316,0,648,6511
ROC,ATL,Atlantic Southeast Airlines,2474,629,1651,0,674,5428
ROC,ATL,Delta Air Lines Inc.,656,471,1060,0,675,2862
ROC,CLT,US Airways Inc.,913,80,64,0,0,1057
ROC,DFW,American Eagle Airlines Inc.,1140,6,169,0,0,1315
ROC,JFK,JetBlue Airways,1126,391,5751,15,5436,12719
ROC,MCO,JetBlue Airways,401,0,136,0,0,537
ROC,ORD,American Eagle Airlines Inc.,1522,1003,8781,0,6007,17313
ROC,ORD,United Air Lines Inc.,1041,607,4093,0,2238,7979
ROW,DFW,American Eagle Airlines Inc.,2082,1074,194,8,1393,4751
RST,ORD,American Eagle Airlines Inc.,1695,116,10807,0,12773,25391
RSW,ATL,Delta Air Lines Inc.,1741,56,2534,0,2798,7129
RSW,BDL,Delta Air Lines Inc.,405,0,150,0,885,1440
RSW,BOS,Delta Air Lines Inc.,367,0,52,0,1023,1442
RSW,BOS,JetBlue Airways,2101,0,2141,0,2473,6715
RSW,BUF,JetBlue Airways,680,0,247,0,1293,2220
RSW,BWI,Southwest Airlines Co.,293,40,791,12,2147,3283
RSW,CLT,US Airways Inc.,1062,0,697,0,2488,4247
RSW,CVG,Delta Air Lines Inc.,397,124,198,0,938,1657
RSW,DCA,US Airways Inc.,136,0,176,0,129,441
RSW,DEN,Frontier Airlines Inc.,104,0,370,0,76,550
RSW,DFW,American Airlines Inc.,1449,98,834,0,2793,5174
RSW,EWR,JetBlue Airways,389,0,6107,0,1559,8055
RSW,HPN,JetBlue Airways,384,0,325,0,2260,2969
RSW,ISP,Southwest Airlines Co.,349,119,258,0,1367,2093
RSW,JFK,JetBlue Airways,2008,0,8026,3,6383,16420
RSW,LGA,Delta Air Lines Inc.,380,0,1431,0,1021,2832
RSW,MCO,Southwest Airlines Co.,537,305,287,79,2955,4163
RSW,MDW,Southwest Airlines Co.,553,224,620,0,3402,4799
RSW,ORD,American Airlines Inc.,1022,0,6516,42,2663,10243
RSW,PHL,Southwest Airlines Co.,57,653,1362,0,783,2855
RSW,PHL,US Airways Inc.,686,73,2433,0,1535,4727
RSW,PIT,US Airways Inc.,5,0,0,0,192,197
RSW,STL,American Airlines Inc.,2162,47,124,0,868,3201
SAN,ABQ,Southwest Airlines Co.,418,26,152,0,3346,3942
SAN,ATL,Delta Air Lines Inc.,1377,192,732,155,1731,4187
SAN,AUS,Southwest Airlines Co.,552,0,66,0,922,1540
SAN,BNA,Southwest Airlines Co.,595,38,158,0,1482,2273
SAN,BOS,American Airlines Inc.,572,0,333,0,290,1195
SAN,BOS,JetBlue Airways,245,0,331,0,546,1122
SAN,BWI,Southwest Airlines Co.,717,11,339,0,538,1605
SAN,CLT,US Airways Inc.,681,6,212,62,401,1362
SAN,CVG,Delta Air Lines Inc.,338,0,125,0,971,1434
SAN,DEN,Frontier Airlines Inc.,1276,12,1816,112,2950,6166
SAN,DEN,Southwest Airlines Co.,662,93,319,6,1716,2796
SAN,DEN,United Air Lines Inc.,2850,89,573,0,8240,11752
SAN,DFW,American Airlines Inc.,4342,358,2093,302,10363,17458
SAN,ELP,Southwest Airlines Co.,229,7,153,0,1153,1542
SAN,HNL,Hawaiian Airlines Inc.,1920,35,0,0,323,2278
SAN,HNL,United Air Lines Inc.,144,0,67,0,162,373
SAN,HOU,Southwest Airlines Co.,283,14,157,0,1058,1512
SAN,IAD,JetBlue Airways,330,0,207,0,163,700
SAN,IAD,United Air Lines Inc.,1207,475,790,0,3967,6439
SAN,JFK,American Airlines Inc.,789,0,549,0,52,1390
SAN,JFK,Delta Air Lines Inc.,251,95,48,0,0,394
SAN,JFK,JetBlue Airways,392,0,1260,0,1613,3265
SAN,LAS,Southwest Airlines Co.,3413,445,4812,19,16553,25242
SAN,LAS,US Airways Inc.,390,0,619,0,1900,2909
SAN,LAX,American Eagle Airlines Inc.,3395,118,2016,31,5138,10698
SAN,LAX,Skywest Airlines Inc.,7272,2675,5005,231,6882,22065
SAN,MCI,Southwest Airlines Co.,349,0,271,0,1643,2263
SAN,MDW,Southwest Airlines Co.,1020,227,539,0,3270,5056
SAN,OAK,Southwest Airlines Co.,4177,131,3076,49,23975,31408
SAN,OGG,Hawaiian Airlines Inc.,783,0,10,0,279,1072
SAN,ORD,American Airlines Inc.,1379,23,8211,158,6582,16353
SAN,ORD,United Air Lines Inc.,2186,277,4341,0,4711,11515
SAN,PDX,Alaska Airlines Inc.,1324,17,758,0,3340,5439
SAN,PHL,US Airways Inc.,981,0,572,144,1583,3280
SAN,PHX,Southwest Airlines Co.,2835,349,2216,13,15717,21130
SAN,PHX,US Airways Inc.,2542,72,779,96,2461,5950
SAN,RNO,Southwest Airlines Co.,517,76,556,0,3114,4263
SAN,SAT,Southwest Airlines Co.,301,0,48,0,477,826
SAN,SEA,Alaska Airlines Inc.,2960,1,1290,8,4268,8527
SAN,SEA,JetBlue Airways,0,0,16,0,32,48
SAN,SFO,Southwest Airlines Co.,2890,753,14161,5,10136,27945
SAN,SFO,United Air Lines Inc.,4653,74,18469,0,15754,38950
SAN,SJC,American Eagle Airlines Inc.,797,170,801,0,2727,4495
SAN,SJC,Southwest Airlines Co.,2164,439,2034,23,13426,18086
SAN,SLC,Delta Air Lines Inc.,462,269,206,49,1939,2925
SAN,SLC,JetBlue Airways,508,0,63,0,770,1341
SAN,SLC,Skywest Airlines Inc.,280,235,174,81,1792,2562
SAN,SMF,Southwest Airlines Co.,3421,256,1861,11,16459,22008
SAN,STL,American Airlines Inc.,563,189,295,37,1803,2887
SAN,TUS,Southwest Airlines Co.,671,16,177,53,4440,5357
SAT,ATL,Atlantic Southeast Airlines,4105,1083,1066,398,613,7265
SAT,ATL,Delta Air Lines Inc.,3838,282,1515,0,1643,7278
SAT,BNA,Southwest Airlines Co.,629,0,76,3,2048,2756
SAT,BWI,Southwest Airlines Co.,262,126,576,0,824,1788
SAT,DAL,Southwest Airlines Co.,3124,1503,2887,5,14597,22116
SAT,DEN,Frontier Airlines Inc.,701,0,783,0,1047,2531
SAT,DEN,Skywest Airlines Inc.,334,124,154,0,800,1412
SAT,DEN,Southwest Airlines Co.,320,13,100,0,432,865
SAT,DEN,United Air Lines Inc.,1059,0,333,0,2536,3928
SAT,DFW,American Airlines Inc.,5287,386,5531,0,15107,26311
SAT,ELP,Southwest Airlines Co.,896,0,243,0,7116,8255
SAT,HOU,Southwest Airlines Co.,2132,969,2226,26,9578,14931
SAT,HRL,Southwest Airlines Co.,384,123,84,0,3439,4030
SAT,LAS,Southwest Airlines Co.,765,155,913,0,3751,5584
SAT,LAX,American Airlines Inc.,259,0,298,0,842,1399
SAT,LAX,Skywest Airlines Inc.,876,76,614,0,2929,4495
SAT,LAX,Southwest Airlines Co.,594,99,326,0,1587,2606
SAT,MCI,Skywest Airlines Inc.,3574,187,150,32,882,4825
SAT,MCO,Southwest Airlines Co.,485,0,58,0,311,854
SAT,MDW,Southwest Airlines Co.,383,354,531,18,1251,2537
SAT,ORD,American Airlines Inc.,374,0,5420,0,2983,8777
SAT,ORD,Skywest Airlines Inc.,192,29,9753,0,1196,11170
SAT,PHL,Southwest Airlines Co.,174,127,995,0,592,1888
SAT,PHX,Southwest Airlines Co.,532,19,590,14,5588,6743
SAT,PHX,US Airways Inc.,265,18,105,0,43,431
SAT,SAN,Southwest Airlines Co.,204,0,195,0,943,1342
SAT,SFO,United Air Lines Inc.,507,0,315,0,0,822
SAT,SLC,Skywest Airlines Inc.,403,124,97,0,1023,1647
SAT,STL,American Airlines Inc.,909,0,62,0,0,971
SAT,TPA,Southwest Airlines Co.,224,0,56,0,245,525
SAV,ATL,Atlantic Southeast Airlines,271,15,262,0,456,1004
SAV,ATL,Delta Air Lines Inc.,4436,299,2221,0,3086,10042
SAV,CLT,US Airways Inc.,539,0,458,0,367,1364
SAV,DFW,American Eagle Airlines Inc.,3076,384,648,0,1385,5493
SAV,ORD,Skywest Airlines Inc.,1421,198,3706,86,1134,6545
SBA,DEN,Skywest Airlines Inc.,1108,408,170,0,1781,3467
SBA,DFW,American Eagle Airlines Inc.,1133,26,61,11,540,1771
SBA,LAX,American Eagle Airlines Inc.,830,339,488,0,1950,3607
SBA,LAX,Skywest Airlines Inc.,3248,236,1429,34,6246,11193
SBA,SFO,Skywest Airlines Inc.,3002,597,26046,43,3645,33333
SBA,SJC,Skywest Airlines Inc.,1517,51,68,56,2208,3900
SBA,SLC,Skywest Airlines Inc.,367,27,18,68,616,1096
SBN,ATL,Atlantic Southeast Airlines,2260,2503,1325,39,613,6740
SBN,ORD,Skywest Airlines Inc.,1103,78,7250,0,2481,10912
SBP,LAX,American Eagle Airlines Inc.,2022,104,402,0,1204,3732
SBP,LAX,Skywest Airlines Inc.,1357,189,768,0,2313,4627
SBP,SFO,Skywest Airlines Inc.,1688,175,14007,0,2339,18209
SBP,SLC,Skywest Airlines Inc.,228,16,0,0,482,726
SCC,ANC,Alaska Airlines Inc.,140,0,48,28,983,1199
SCC,BRW,Alaska Airlines Inc.,283,111,61,86,918,1459
SCE,ATL,Atlantic Southeast Airlines,644,586,481,2,0,1713
SDF,ATL,Atlantic Southeast Airlines,4238,1539,2275,0,1073,9125
SDF,ATL,Delta Air Lines Inc.,2311,9,1751,0,914,4985
SDF,BHM,Southwest Airlines Co.,711,277,218,0,2490,3696
SDF,BWI,Southwest Airlines Co.,1417,350,2031,19,7122,10939
SDF,CLT,US Airways Inc.,18,0,4,0,0,22
SDF,CVG,Atlantic Southeast Airlines,231,243,112,0,43,629
SDF,CVG,Skywest Airlines Inc.,84,0,0,0,0,84
SDF,DEN,Frontier Airlines Inc.,1581,306,998,0,555,3440
SDF,DFW,American Airlines Inc.,3236,1442,1254,0,3558,9490
SDF,DFW,American Eagle Airlines Inc.,1810,453,1189,0,2077,5529
SDF,LAS,Southwest Airlines Co.,232,237,326,0,885,1680
SDF,LGA,American Eagle Airlines Inc.,1752,173,2113,0,1873,5911
SDF,MCO,Atlantic Southeast Airlines,45,27,0,0,0,72
SDF,MCO,Southwest Airlines Co.,483,344,251,0,1505,2583
SDF,MDW,Southwest Airlines Co.,1684,659,3363,6,5123,10835
SDF,MIA,American Eagle Airlines Inc.,430,152,356,0,1551,2489
SDF,MKE,Skywest Airlines Inc.,110,47,170,0,659,986
SDF,ORD,American Eagle Airlines Inc.,2821,155,9870,0,9777,22623
SDF,ORD,Skywest Airlines Inc.,2175,1113,14446,0,5545,23279
SDF,PHX,Southwest Airlines Co.,70,352,114,0,454,990
SDF,RDU,American Eagle Airlines Inc.,841,19,376,0,2517,3753
SDF,SLC,Skywest Airlines Inc.,28,0,32,0,0,60
SDF,STL,Southwest Airlines Co.,629,243,296,75,2251,3494
SDF,TPA,Southwest Airlines Co.,279,24,224,0,1311,1838
SEA,ABQ,Southwest Airlines Co.,871,60,129,15,1029,2104
SEA,ANC,Alaska Airlines Inc.,9522,41,5093,283,4279,19218
SEA,ATL,Delta Air Lines Inc.,1292,69,776,0,1436,3573
SEA,AUS,American Airlines Inc.,172,187,32,0,775,1166
SEA,BNA,Southwest Airlines Co.,598,226,339,0,724,1887
SEA,BOI,Alaska Airlines Inc.,219,0,79,0,207,505
SEA,BOI,Southwest Airlines Co.,729,115,121,5,3548,4518
SEA,BOS,Alaska Airlines Inc.,411,0,239,0,0,650
SEA,BOS,JetBlue Airways,101,0,61,0,369,531
SEA,BUR,Alaska Airlines Inc.,2844,127,439,0,1158,4568
SEA,CLT,US Airways Inc.,677,16,280,53,673,1699
SEA,CVG,Delta Air Lines Inc.,635,9,208,0,657,1509
SEA,DCA,Alaska Airlines Inc.,1243,47,116,15,83,1504
SEA,DEN,Alaska Airlines Inc.,2685,4,608,0,1215,4512
SEA,DEN,Frontier Airlines Inc.,967,4,1384,0,1807,4162
SEA,DEN,Southwest Airlines Co.,882,30,327,9,3781,5029
SEA,DEN,United Air Lines Inc.,4290,157,1129,0,10163,15739
SEA,DFW,Alaska Airlines Inc.,2153,2,605,0,390,3150
SEA,DFW,American Airlines Inc.,6453,397,1961,0,9958,18769
SEA,EWR,Alaska Airlines Inc.,1091,4,3196,0,250,4541
SEA,FAI,Alaska Airlines Inc.,1459,0,575,0,985,3019
SEA,GEG,Alaska Airlines Inc.,3400,60,855,27,1471,5813
SEA,GEG,Skywest Airlines Inc.,976,297,32,0,899,2204
SEA,GEG,Southwest Airlines Co.,1554,230,396,9,4454,6643
SEA,HNL,Alaska Airlines Inc.,318,0,53,0,0,371
SEA,HNL,Hawaiian Airlines Inc.,1715,7,0,0,25,1747
SEA,HNL,United Air Lines Inc.,57,0,70,0,1254,1381
SEA,IAD,United Air Lines Inc.,2169,87,705,0,4089,7050
SEA,JFK,American Airlines Inc.,572,0,545,0,0,1117
SEA,JFK,Delta Air Lines Inc.,533,0,608,0,602,1743
SEA,JFK,JetBlue Airways,121,0,192,0,515,828
SEA,JNU,Alaska Airlines Inc.,2445,300,430,0,370,3545
SEA,KTN,Alaska Airlines Inc.,3491,136,1086,78,1982,6773
SEA,LAS,Alaska Airlines Inc.,4633,89,2080,65,4474,11341
SEA,LAS,Southwest Airlines Co.,1777,142,559,3,2815,5296
SEA,LAS,US Airways Inc.,1301,10,580,0,1397,3288
SEA,LAX,Alaska Airlines Inc.,6089,17,1777,0,2177,10060
SEA,LAX,Skywest Airlines Inc.,425,0,12,0,166,603
SEA,LAX,United Air Lines Inc.,1624,0,399,0,5417,7440
SEA,LGB,Alaska Airlines Inc.,1500,116,321,2,603,2542
SEA,LGB,JetBlue Airways,21,0,0,0,0,21
SEA,LIH,Alaska Airlines Inc.,579,0,57,0,206,842
SEA,MCI,Southwest Airlines Co.,188,89,14,0,659,950
SEA,MCO,Alaska Airlines Inc.,979,21,245,28,113,1386
SEA,MDW,Southwest Airlines Co.,2396,85,1162,0,2405,6048
SEA,MIA,Alaska Airlines Inc.,688,0,193,25,79,985
SEA,OAK,Alaska Airlines Inc.,3447,0,476,0,2585,6508
SEA,OAK,Southwest Airlines Co.,2898,109,376,0,7002,10385
SEA,OGG,Hawaiian Airlines Inc.,465,0,0,0,250,715
SEA,ONT,Alaska Airlines Inc.,2627,0,474,9,1264,4374
SEA,ORD,Alaska Airlines Inc.,1690,8,11405,12,324,13439
SEA,ORD,American Airlines Inc.,2395,156,8989,0,3802,15342
SEA,ORD,United Air Lines Inc.,2906,535,3406,0,7166,14013
SEA,PDX,Skywest Airlines Inc.,2149,150,292,19,1841,4451
SEA,PHL,US Airways Inc.,1804,15,604,0,988,3411
SEA,PHX,Alaska Airlines Inc.,3822,33,1030,0,2244,7129
SEA,PHX,Southwest Airlines Co.,1015,40,158,0,1655,2868
SEA,PHX,US Airways Inc.,2847,41,364,8,1335,4595
SEA,PSP,Alaska Airlines Inc.,1332,7,320,0,530,2189
SEA,RNO,Alaska Airlines Inc.,457,0,123,0,89,669
SEA,RNO,Southwest Airlines Co.,495,32,113,22,2921,3583
SEA,SAN,Alaska Airlines Inc.,5374,158,878,11,3729,10150
SEA,SAN,JetBlue Airways,2,0,0,0,20,22
SEA,SFO,Alaska Airlines Inc.,4057,40,10328,0,1590,16015
SEA,SFO,United Air Lines Inc.,2356,289,8646,0,11574,22865
SEA,SJC,Alaska Airlines Inc.,4482,92,489,32,2014,7109
SEA,SJC,Southwest Airlines Co.,1393,88,110,0,2609,4200
SEA,SLC,Delta Air Lines Inc.,2540,172,537,0,1592,4841
SEA,SLC,Skywest Airlines Inc.,446,231,153,0,3196,4026
SEA,SLC,Southwest Airlines Co.,1258,84,289,11,3377,5019
SEA,SMF,Alaska Airlines Inc.,3235,109,424,16,2205,5989
SEA,SMF,Southwest Airlines Co.,1395,25,279,36,6846,8581
SEA,SNA,Alaska Airlines Inc.,4653,184,816,0,1330,6983
SEA,STL,American Airlines Inc.,955,24,305,0,908,2192
SEA,TUS,Alaska Airlines Inc.,152,0,48,0,127,327
SFO,ABQ,Skywest Airlines Inc.,3705,58,148,92,1901,5904
SFO,ACV,Skywest Airlines Inc.,14690,836,839,0,2922,19287
SFO,ANC,United Air Lines Inc.,121,30,85,0,695,931
SFO,ASE,Skywest Airlines Inc.,196,0,75,0,148,419
SFO,ATL,Delta Air Lines Inc.,2077,965,779,0,4154,7975
SFO,ATL,United Air Lines Inc.,1065,0,370,0,503,1938
SFO,AUS,JetBlue Airways,1,0,0,0,28,29
SFO,AUS,United Air Lines Inc.,679,277,223,0,1943,3122
SFO,BFL,Skywest Airlines Inc.,4833,108,162,0,2116,7219
SFO,BOI,Skywest Airlines Inc.,9673,0,533,152,5601,15959
SFO,BOS,American Airlines Inc.,1991,35,1095,0,2301,5422
SFO,BOS,JetBlue Airways,197,75,108,0,1600,1980
SFO,BOS,United Air Lines Inc.,4383,33,1761,0,5437,11614
SFO,BUR,Skywest Airlines Inc.,4752,597,305,0,4714,10368
SFO,BUR,United Air Lines Inc.,1237,7,246,0,4039,5529
SFO,BWI,United Air Lines Inc.,1098,13,159,0,2770,4040
SFO,BZN,Skywest Airlines Inc.,252,0,7,0,179,438
SFO,CEC,Skywest Airlines Inc.,5961,0,333,0,2348,8642
SFO,CIC,Skywest Airlines Inc.,9980,296,489,0,4473,15238
SFO,CLT,US Airways Inc.,869,768,537,0,365,2539
SFO,COS,Skywest Airlines Inc.,3319,178,1,0,1025,4523
SFO,CVG,Delta Air Lines Inc.,420,17,573,0,1833,2843
SFO,DEN,Frontier Airlines Inc.,1535,10,2286,0,4889,8720
SFO,DEN,United Air Lines Inc.,7237,724,1699,0,14147,23807
SFO,DFW,American Airlines Inc.,9308,299,3577,25,12880,26089
SFO,DFW,United Air Lines Inc.,777,95,228,0,1295,2395
SFO,EUG,Skywest Airlines Inc.,8146,499,203,97,5698,14643
SFO,EUG,United Air Lines Inc.,1976,12,300,0,3241,5529
SFO,EWR,United Air Lines Inc.,1570,436,5782,0,5082,12870
SFO,FAT,Skywest Airlines Inc.,15244,95,688,0,5137,21164
SFO,HNL,American Airlines Inc.,2092,0,130,0,25,2247
SFO,HNL,Hawaiian Airlines Inc.,4533,144,0,0,149,4826
SFO,HNL,United Air Lines Inc.,4490,738,501,0,4055,9784
SFO,IAD,United Air Lines Inc.,5624,583,1874,0,6740,14821
SFO,IAH,United Air Lines Inc.,1316,109,376,0,954,2755
SFO,JFK,American Airlines Inc.,6181,113,5308,0,10095,21697
SFO,JFK,Delta Air Lines Inc.,1216,667,956,0,2053,4892
SFO,JFK,JetBlue Airways,691,189,2182,3,4425,7490
SFO,JFK,United Air Lines Inc.,4274,683,10841,0,8425,24223
SFO,KOA,United Air Lines Inc.,2504,701,516,0,2709,6430
SFO,LAS,Southwest Airlines Co.,1154,727,2011,0,15245,19137
SFO,LAS,US Airways Inc.,2193,472,2103,0,9054,13822
SFO,LAS,United Air Lines Inc.,5059,616,2748,0,13257,21680
SFO,LAX,Alaska Airlines Inc.,536,0,343,0,0,879
SFO,LAX,American Airlines Inc.,3288,145,2998,0,18131,24562
SFO,LAX,Southwest Airlines Co.,1817,394,1725,64,19879,23879
SFO,LAX,United Air Lines Inc.,10487,122,3846,0,34323,48778
SFO,LIH,United Air Lines Inc.,739,463,225,0,530,1957
SFO,MCO,United Air Lines Inc.,718,110,236,0,2835,3899
SFO,MDW,Southwest Airlines Co.,805,423,800,0,6414,8442
SFO,MFR,Skywest Airlines Inc.,16522,754,1558,0,4976,23810
SFO,MIA,American Airlines Inc.,3845,130,1492,0,3248,8715
SFO,MOD,Skywest Airlines Inc.,8726,386,272,0,4283,13667
SFO,MRY,Skywest Airlines Inc.,10785,731,1076,68,3516,16176
SFO,OGG,United Air Lines Inc.,4251,566,414,0,1825,7056
SFO,ONT,Skywest Airlines Inc.,6779,154,386,18,6615,13952
SFO,ORD,American Airlines Inc.,3593,177,12529,1,9602,25902
SFO,ORD,United Air Lines Inc.,8943,567,10171,0,12036,31717
SFO,PDX,Alaska Airlines Inc.,2332,0,956,0,7230,10518
SFO,PDX,United Air Lines Inc.,5087,73,1546,0,12743,19449
SFO,PHL,US Airways Inc.,2114,620,1582,0,2191,6507
SFO,PHL,United Air Lines Inc.,2130,6,1725,0,4607,8468
SFO,PHX,Southwest Airlines Co.,327,0,57,0,2938,3322
SFO,PHX,US Airways Inc.,1254,0,605,0,2928,4787
SFO,PHX,United Air Lines Inc.,3217,183,832,0,7062,11294
SFO,PIT,US Airways Inc.,240,0,4,0,718,962
SFO,PMD,Skywest Airlines Inc.,790,0,10,0,1553,2353
SFO,PSP,Alaska Airlines Inc.,1513,0,645,9,6241,8408
SFO,PSP,Skywest Airlines Inc.,2271,0,80,0,2426,4777
SFO,RDD,Skywest Airlines Inc.,9940,155,1191,0,4187,15473
SFO,RDM,Skywest Airlines Inc.,6706,395,588,0,1200,8889
SFO,RNO,Skywest Airlines Inc.,8501,50,158,0,2732,11441
SFO,RNO,United Air Lines Inc.,1553,34,273,0,2736,4596
SFO,SAN,Southwest Airlines Co.,2030,129,1335,0,20298,23792
SFO,SAN,United Air Lines Inc.,7903,201,1527,0,18228,27859
SFO,SAT,United Air Lines Inc.,923,0,99,0,843,1865
SFO,SBA,Skywest Airlines Inc.,14165,1080,767,0,8192,24204
SFO,SBP,Skywest Airlines Inc.,6897,251,528,0,4060,11736
SFO,SEA,Alaska Airlines Inc.,5727,451,2598,65,14945,23786
SFO,SEA,United Air Lines Inc.,7356,577,2244,0,14794,24971
SFO,SLC,Delta Air Lines Inc.,251,0,129,0,1236,1616
SFO,SLC,JetBlue Airways,198,0,133,0,1836,2167
SFO,SLC,Skywest Airlines Inc.,11017,494,4453,0,11473,27437
SFO,SLC,United Air Lines Inc.,1256,58,371,0,3505,5190
SFO,SMF,Skywest Airlines Inc.,11341,568,647,0,2945,15501
SFO,SNA,American Eagle Airlines Inc.,742,34,1025,0,4801,6602
SFO,SNA,Skywest Airlines Inc.,1450,24,104,0,2032,3610
SFO,SNA,United Air Lines Inc.,2773,188,629,0,5518,9108
SFO,STL,American Airlines Inc.,1624,0,434,0,1195,3253
SFO,TUS,Skywest Airlines Inc.,1700,0,138,0,1728,3566
SGF,ATL,Atlantic Southeast Airlines,3813,953,1487,11,363,6627
SGF,BNA,Skywest Airlines Inc.,0,0,0,0,109,109
SGF,CVG,Atlantic Southeast Airlines,555,230,65,0,0,850
SGF,DEN,Skywest Airlines Inc.,2391,956,627,0,1735,5709
SGF,DFW,American Eagle Airlines Inc.,12752,4534,4333,40,7207,28866
SGF,ORD,American Eagle Airlines Inc.,8017,2212,3783,8,2503,16523
SGF,ORD,Skywest Airlines Inc.,1777,774,19208,0,2088,23847
SGF,STL,American Eagle Airlines Inc.,2218,470,527,0,0,3215
SGU,LAX,Skywest Airlines Inc.,1551,23,88,0,1021,2683
SGU,SLC,Skywest Airlines Inc.,1712,653,273,39,1798,4475
SHV,ATL,Atlantic Southeast Airlines,3668,1168,1862,36,1077,7811
SHV,DFW,American Eagle Airlines Inc.,3047,3288,2593,19,11026,19973
SHV,ORD,American Eagle Airlines Inc.,1298,364,1461,0,2029,5152
SIT,JNU,Alaska Airlines Inc.,1336,343,305,21,1845,3850
SIT,KTN,Alaska Airlines Inc.,218,2,84,0,1413,1717
SJC,ATL,Delta Air Lines Inc.,458,0,122,0,1594,2174
SJC,AUS,American Airlines Inc.,1013,65,154,3,3158,4393
SJC,BOS,JetBlue Airways,116,0,56,0,738,910
SJC,BUR,Southwest Airlines Co.,2099,161,155,16,8430,10861
SJC,DEN,Frontier Airlines Inc.,586,263,609,0,1089,2547
SJC,DEN,Southwest Airlines Co.,235,28,129,2,1049,1443
SJC,DEN,United Air Lines Inc.,2266,235,500,0,4313,7314
SJC,DFW,American Airlines Inc.,3157,469,683,20,2303,6632
SJC,HNL,Hawaiian Airlines Inc.,799,24,0,13,37,873
SJC,IAD,United Air Lines Inc.,409,0,10,0,0,419
SJC,JFK,JetBlue Airways,138,0,276,0,614,1028
SJC,LAS,Southwest Airlines Co.,1767,1027,2907,64,11129,16894
SJC,LAS,US Airways Inc.,742,172,712,0,1982,3608
SJC,LAX,American Eagle Airlines Inc.,1140,7,1222,15,4991,7375
SJC,LAX,Skywest Airlines Inc.,1411,168,417,0,3332,5328
SJC,LAX,Southwest Airlines Co.,2946,266,2499,151,13580,19442
SJC,LGB,JetBlue Airways,35,0,10,0,41,86
SJC,MDW,Southwest Airlines Co.,448,90,577,0,963,2078
SJC,ONT,Southwest Airlines Co.,2215,19,94,14,6833,9175
SJC,ORD,American Airlines Inc.,1113,0,4953,0,1739,7805
SJC,ORD,United Air Lines Inc.,1073,0,4133,0,2668,7874
SJC,PDX,Alaska Airlines Inc.,2168,15,287,0,2075,4545
SJC,PDX,Southwest Airlines Co.,889,0,406,13,5463,6771
SJC,PHX,Southwest Airlines Co.,1592,243,478,53,5959,8325
SJC,PHX,US Airways Inc.,1831,189,237,0,1973,4230
SJC,RNO,Southwest Airlines Co.,1128,85,80,24,4748,6065
SJC,SAN,American Eagle Airlines Inc.,1022,18,306,0,2760,4106
SJC,SAN,Southwest Airlines Co.,2211,109,651,142,10828,13941
SJC,SBA,Skywest Airlines Inc.,562,75,127,0,2931,3695
SJC,SEA,Alaska Airlines Inc.,2310,42,707,131,4064,7254
SJC,SEA,Southwest Airlines Co.,907,10,490,18,3106,4531
SJC,SLC,Delta Air Lines Inc.,320,207,67,0,70,664
SJC,SLC,Skywest Airlines Inc.,117,233,71,0,1640,2061
SJC,SNA,American Airlines Inc.,217,5,251,0,2827,3300
SJC,SNA,American Eagle Airlines Inc.,1012,93,218,0,1325,2648
SJC,SNA,Southwest Airlines Co.,1019,166,312,48,5799,7344
SJT,DFW,American Eagle Airlines Inc.,959,1173,735,0,3663,6530
SJU,ATL,Delta Air Lines Inc.,2814,0,585,0,1615,5014
SJU,BDL,American Airlines Inc.,530,7,385,0,1241,2163
SJU,BOS,American Airlines Inc.,2425,367,805,23,1955,5575
SJU,BOS,JetBlue Airways,131,0,39,0,527,697
SJU,BOS,US Airways Inc.,152,0,246,13,609,1020
SJU,BWI,American Airlines Inc.,1073,0,286,0,1866,3225
SJU,CLT,US Airways Inc.,986,34,196,17,1318,2551
SJU,DFW,American Airlines Inc.,1230,0,494,36,2437,4197
SJU,EWR,American Airlines Inc.,1142,0,209,41,1404,2796
SJU,FLL,American Airlines Inc.,2097,51,515,0,3464,6127
SJU,IAD,American Airlines Inc.,2235,0,25,0,531,2791
SJU,IAD,United Air Lines Inc.,1356,0,409,0,2398,4163
SJU,JFK,American Airlines Inc.,8959,6,2784,30,8410,20189
SJU,JFK,Delta Air Lines Inc.,342,0,138,0,646,1126
SJU,JFK,JetBlue Airways,534,0,291,0,2325,3150
SJU,LAX,American Airlines Inc.,74,0,93,0,417,584
SJU,MCO,American Airlines Inc.,8651,0,1525,0,4934,15110
SJU,MCO,Delta Air Lines Inc.,0,7,33,0,0,40
SJU,MCO,JetBlue Airways,915,0,312,0,1656,2883
SJU,MIA,American Airlines Inc.,9201,91,2153,0,10727,22172
SJU,ORD,American Airlines Inc.,1567,0,315,0,1085,2967
SJU,ORD,United Air Lines Inc.,623,0,394,0,2016,3033
SJU,PHL,American Airlines Inc.,1260,0,156,0,566,1982
SJU,PHL,US Airways Inc.,2534,7,723,39,7573,10876
SJU,STT,American Airlines Inc.,313,0,85,0,346,744
SJU,TPA,American Airlines Inc.,604,0,233,0,2368,3205
SLC,ABQ,Skywest Airlines Inc.,1036,398,57,0,792,2283
SLC,ABQ,Southwest Airlines Co.,587,88,233,0,1821,2729
SLC,ACV,Skywest Airlines Inc.,388,0,19,0,0,407
SLC,ANC,Delta Air Lines Inc.,351,135,283,0,227,996
SLC,ASE,Skywest Airlines Inc.,1641,686,166,39,397,2929
SLC,ATL,Delta Air Lines Inc.,4628,760,1586,0,2740,9714
SLC,AUS,Skywest Airlines Inc.,1730,512,64,39,855,3200
SLC,BFL,Skywest Airlines Inc.,335,219,19,0,665,1238
SLC,BHM,Skywest Airlines Inc.,204,0,0,0,0,204
SLC,BIL,Skywest Airlines Inc.,2857,505,87,0,541,3990
SLC,BLI,Skywest Airlines Inc.,269,0,0,0,0,269
SLC,BNA,Skywest Airlines Inc.,639,130,7,19,144,939
SLC,BOI,Delta Air Lines Inc.,872,120,463,0,603,2058
SLC,BOI,Skywest Airlines Inc.,2296,646,53,51,880,3926
SLC,BOI,Southwest Airlines Co.,1123,241,547,0,5007,6918
SLC,BOS,Delta Air Lines Inc.,289,73,273,0,707,1342
SLC,BTM,Skywest Airlines Inc.,607,372,7,0,157,1143
SLC,BUR,JetBlue Airways,181,0,206,0,499,886
SLC,BUR,Skywest Airlines Inc.,3346,546,257,21,597,4767
SLC,BWI,Delta Air Lines Inc.,177,8,174,0,160,519
SLC,BWI,Southwest Airlines Co.,217,2,274,0,724,1217
SLC,BZN,Skywest Airlines Inc.,4330,1661,119,0,1826,7936
SLC,CDC,Skywest Airlines Inc.,1347,0,18,0,215,1580
SLC,CLE,Delta Air Lines Inc.,137,0,6,0,141,284
SLC,CLE,Skywest Airlines Inc.,188,178,2,64,234,666
SLC,CLT,Delta Air Lines Inc.,573,0,107,0,339,1019
SLC,CMH,Skywest Airlines Inc.,530,35,63,0,21,649
SLC,COD,Skywest Airlines Inc.,1224,309,27,0,307,1867
SLC,COS,Skywest Airlines Inc.,887,558,37,0,383,1865
SLC,CPR,Skywest Airlines Inc.,1076,371,0,0,295,1742
SLC,CVG,Delta Air Lines Inc.,2163,222,401,0,1478,4264
SLC,CVG,Skywest Airlines Inc.,300,0,86,0,0,386
SLC,DCA,Delta Air Lines Inc.,287,33,196,0,284,800
SLC,DEN,Delta Air Lines Inc.,724,0,383,0,719,1826
SLC,DEN,Frontier Airlines Inc.,2034,148,3526,0,3754,9462
SLC,DEN,Skywest Airlines Inc.,6548,1617,564,20,1682,10431
SLC,DEN,Southwest Airlines Co.,1557,218,630,0,5073,7478
SLC,DEN,United Air Lines Inc.,712,88,835,0,8525,10160
SLC,DFW,American Airlines Inc.,3579,107,1105,0,4705,9496
SLC,DFW,Delta Air Lines Inc.,881,218,656,0,502,2257
SLC,DFW,Skywest Airlines Inc.,1931,214,309,0,55,2509
SLC,DRO,Skywest Airlines Inc.,754,87,14,0,411,1266
SLC,DSM,Skywest Airlines Inc.,116,0,0,0,0,116
SLC,DTW,Delta Air Lines Inc.,253,54,302,0,84,693
SLC,DTW,Skywest Airlines Inc.,385,0,0,0,0,385
SLC,EKO,Skywest Airlines Inc.,2080,696,67,0,1017,3860
SLC,ELP,Skywest Airlines Inc.,115,0,0,0,40,155
SLC,EUG,Skywest Airlines Inc.,671,196,84,0,68,1019
SLC,EWR,Delta Air Lines Inc.,143,434,3365,0,756,4698
SLC,FAI,Delta Air Lines Inc.,60,0,0,0,0,60
SLC,FAR,Skywest Airlines Inc.,289,11,4,0,40,344
SLC,FAT,Skywest Airlines Inc.,892,528,106,0,494,2020
SLC,FCA,Skywest Airlines Inc.,2252,509,243,37,1057,4098
SLC,FLL,Delta Air Lines Inc.,362,6,150,0,404,922
SLC,FSD,Skywest Airlines Inc.,58,0,0,0,0,58
SLC,GEG,Delta Air Lines Inc.,783,28,274,0,1016,2101
SLC,GEG,Skywest Airlines Inc.,2574,823,48,86,1135,4666
SLC,GEG,Southwest Airlines Co.,177,35,96,7,1811,2126
SLC,GJT,Skywest Airlines Inc.,1047,160,86,16,690,1999
SLC,GTF,Skywest Airlines Inc.,1110,243,8,0,288,1649
SLC,HDN,Skywest Airlines Inc.,968,420,111,0,278,1777
SLC,HLN,Skywest Airlines Inc.,1846,368,175,0,1030,3419
SLC,HNL,Delta Air Lines Inc.,553,208,173,0,899,1833
SLC,IAD,Delta Air Lines Inc.,736,0,163,0,187,1086
SLC,IAH,Skywest Airlines Inc.,2135,493,1027,0,366,4021
SLC,IDA,Skywest Airlines Inc.,2885,713,352,60,719,4729
SLC,JAC,Delta Air Lines Inc.,401,29,109,0,277,816
SLC,JAC,Skywest Airlines Inc.,4597,970,220,278,1093,7158
SLC,JFK,Delta Air Lines Inc.,803,168,1331,0,1115,3417
SLC,JFK,JetBlue Airways,466,0,302,0,1181,1949
SLC,LAS,Delta Air Lines Inc.,2269,22,1857,0,1372,5520
SLC,LAS,JetBlue Airways,108,0,1,0,236,345
SLC,LAS,Skywest Airlines Inc.,2040,113,460,0,479,3092
SLC,LAS,Southwest Airlines Co.,2061,770,2586,6,8694,14117
SLC,LAS,US Airways Inc.,6,0,20,0,64,90
SLC,LAX,Delta Air Lines Inc.,2660,132,1850,0,1786,6428
SLC,LAX,Skywest Airlines Inc.,4071,1133,625,80,1620,7529
SLC,LAX,Southwest Airlines Co.,1109,294,972,0,4571,6946
SLC,LGA,Delta Air Lines Inc.,61,0,52,0,15,128
SLC,LGB,JetBlue Airways,344,0,337,0,1293,1974
SLC,LGB,Skywest Airlines Inc.,1800,895,34,42,1149,3920
SLC,LIT,Skywest Airlines Inc.,83,215,36,0,0,334
SLC,LWS,Skywest Airlines Inc.,556,115,121,0,177,969
SLC,MCI,Skywest Airlines Inc.,1034,267,26,0,384,1711
SLC,MCO,Delta Air Lines Inc.,721,13,198,0,728,1660
SLC,MDW,Southwest Airlines Co.,593,80,1017,0,1248,2938
SLC,MFR,Skywest Airlines Inc.,323,298,30,0,786,1437
SLC,MKE,Skywest Airlines Inc.,183,0,0,0,0,183
SLC,MRY,Skywest Airlines Inc.,0,91,0,0,0,91
SLC,MSO,Skywest Airlines Inc.,3035,727,109,28,1206,5105
SLC,MSP,Delta Air Lines Inc.,127,0,31,0,149,307
SLC,MSP,Skywest Airlines Inc.,2826,721,221,0,206,3974
SLC,MSY,Skywest Airlines Inc.,495,320,0,0,202,1017
SLC,MTJ,Skywest Airlines Inc.,1456,664,15,0,121,2256
SLC,OAK,Delta Air Lines Inc.,64,0,12,0,30,106
SLC,OAK,Skywest Airlines Inc.,2812,396,152,10,171,3541
SLC,OAK,Southwest Airlines Co.,1122,330,946,0,5002,7400
SLC,OGG,Delta Air Lines Inc.,680,78,211,0,32,1001
SLC,OKC,Skywest Airlines Inc.,64,20,0,0,35,119
SLC,OMA,Skywest Airlines Inc.,952,529,91,0,132,1704
SLC,ONT,Delta Air Lines Inc.,315,70,65,0,375,825
SLC,ONT,Skywest Airlines Inc.,1632,309,73,0,129,2143
SLC,ORD,American Airlines Inc.,721,27,3814,0,2023,6585
SLC,ORD,Delta Air Lines Inc.,239,156,3472,0,753,4620
SLC,ORD,Skywest Airlines Inc.,295,833,1116,0,0,2244
SLC,ORD,United Air Lines Inc.,1040,702,4384,0,4491,10617
SLC,PDX,Delta Air Lines Inc.,781,24,322,0,1356,2483
SLC,PDX,Skywest Airlines Inc.,2622,534,51,81,603,3891
SLC,PDX,Southwest Airlines Co.,443,219,376,0,3453,4491
SLC,PHL,Delta Air Lines Inc.,597,159,941,0,850,2547
SLC,PHX,Delta Air Lines Inc.,700,260,714,0,945,2619
SLC,PHX,Skywest Airlines Inc.,3592,553,405,84,1150,5784
SLC,PHX,Southwest Airlines Co.,2131,183,1241,0,8949,12504
SLC,PHX,US Airways Inc.,1301,124,889,0,2792,5106
SLC,PIH,Skywest Airlines Inc.,3282,525,31,0,1179,5017
SLC,PIT,Delta Air Lines Inc.,298,159,172,0,76,705
SLC,PIT,Skywest Airlines Inc.,369,0,5,0,0,374
SLC,PSC,Skywest Airlines Inc.,3894,255,51,45,1557,5802
SLC,PSP,Skywest Airlines Inc.,1294,577,66,0,572,2509
SLC,RAP,Skywest Airlines Inc.,748,224,4,0,254,1230
SLC,RDM,Skywest Airlines Inc.,1006,275,73,0,315,1669
SLC,RDU,Delta Air Lines Inc.,249,7,76,0,437,769
SLC,RNO,Delta Air Lines Inc.,559,90,230,0,224,1103
SLC,RNO,Skywest Airlines Inc.,1545,421,31,0,346,2343
SLC,RNO,Southwest Airlines Co.,141,73,230,0,990,1434
SLC,SAN,Delta Air Lines Inc.,928,144,523,0,1075,2670
SLC,SAN,JetBlue Airways,214,0,86,0,478,778
SLC,SAN,Skywest Airlines Inc.,1626,77,93,0,244,2040
SLC,SAN,Southwest Airlines Co.,0,0,26,0,54,80
SLC,SAT,Skywest Airlines Inc.,1728,377,82,42,293,2522
SLC,SBA,Skywest Airlines Inc.,582,440,53,0,268,1343
SLC,SBP,Skywest Airlines Inc.,543,265,92,0,203,1103
SLC,SDF,Skywest Airlines Inc.,103,0,0,0,0,103
SLC,SEA,Delta Air Lines Inc.,1775,119,751,0,1922,4567
SLC,SEA,Skywest Airlines Inc.,3132,874,230,40,856,5132
SLC,SEA,Southwest Airlines Co.,962,162,592,0,2387,4103
SLC,SFO,Delta Air Lines Inc.,188,1,1213,0,635,2037
SLC,SFO,JetBlue Airways,136,0,1619,0,1878,3633
SLC,SFO,Skywest Airlines Inc.,6298,1798,18134,565,4052,30847
SLC,SFO,United Air Lines Inc.,710,34,1743,0,255,2742
SLC,SGU,Skywest Airlines Inc.,3377,1056,166,68,292,4959
SLC,SJC,Delta Air Lines Inc.,556,0,190,0,472,1218
SLC,SJC,Skywest Airlines Inc.,1223,422,15,0,324,1984
SLC,SLE,Skywest Airlines Inc.,1200,310,82,0,231,1823
SLC,SMF,Delta Air Lines Inc.,894,195,216,0,567,1872
SLC,SMF,Skywest Airlines Inc.,1193,551,31,0,387,2162
SLC,SNA,Delta Air Lines Inc.,1885,130,566,0,845,3426
SLC,SNA,Skywest Airlines Inc.,1107,778,23,0,310,2218
SLC,STL,Skywest Airlines Inc.,3007,596,165,101,755,4624
SLC,STL,Southwest Airlines Co.,558,97,298,0,1745,2698
SLC,SUN,Skywest Airlines Inc.,3427,662,96,30,609,4824
SLC,TPA,Delta Air Lines Inc.,251,183,295,0,96,825
SLC,TUL,Skywest Airlines Inc.,725,496,151,0,241,1613
SLC,TUS,Skywest Airlines Inc.,2908,620,23,104,638,4293
SLC,TWF,Skywest Airlines Inc.,3688,1176,104,15,1601,6584
SLC,WYS,Skywest Airlines Inc.,183,23,7,0,0,213
SLC,XNA,Skywest Airlines Inc.,69,0,0,0,0,69
SLC,YKM,Skywest Airlines Inc.,594,53,150,0,212,1009
SLC,YUM,Skywest Airlines Inc.,970,207,4,0,424,1605
SLE,SLC,Skywest Airlines Inc.,857,0,0,0,643,1500
SMF,ACV,Skywest Airlines Inc.,647,51,178,0,1982,2858
SMF,ATL,Delta Air Lines Inc.,1173,0,142,0,918,2233
SMF,BUR,Southwest Airlines Co.,2161,213,222,14,8915,11525
SMF,CLT,US Airways Inc.,298,0,27,0,388,713
SMF,DEN,Frontier Airlines Inc.,504,17,946,0,1342,2809
SMF,DEN,United Air Lines Inc.,2167,77,710,0,5752,8706
SMF,DFW,American Airlines Inc.,2207,231,455,0,3329,6222
SMF,HNL,Hawaiian Airlines Inc.,1825,188,0,0,107,2120
SMF,IAD,United Air Lines Inc.,886,192,193,0,120,1391
SMF,JFK,JetBlue Airways,62,0,172,0,1086,1320
SMF,LAS,Southwest Airlines Co.,1844,636,1916,28,8428,12852
SMF,LAS,US Airways Inc.,734,0,652,20,1408,2814
SMF,LAX,Skywest Airlines Inc.,1188,28,759,0,3701,5676
SMF,LAX,Southwest Airlines Co.,2458,51,1800,17,10055,14381
SMF,LAX,United Air Lines Inc.,20,0,34,0,66,120
SMF,LGB,JetBlue Airways,84,15,55,0,1228,1382
SMF,MCI,Southwest Airlines Co.,130,242,4,0,0,376
SMF,MDW,Southwest Airlines Co.,563,142,345,18,1226,2294
SMF,ONT,Southwest Airlines Co.,2209,9,334,19,12439,15010
SMF,ORD,United Air Lines Inc.,3150,377,4295,0,3630,11452
SMF,PDX,Alaska Airlines Inc.,421,8,160,0,1207,1796
SMF,PDX,Southwest Airlines Co.,1826,0,715,9,8146,10696
SMF,PHL,US Airways Inc.,333,0,167,0,0,500
SMF,PHX,Southwest Airlines Co.,1253,63,322,5,5897,7540
SMF,PHX,US Airways Inc.,1564,85,304,0,2163,4116
SMF,SAN,Southwest Airlines Co.,2937,299,611,39,12106,15992
SMF,SBA,Skywest Airlines Inc.,0,0,0,0,23,23
SMF,SEA,Alaska Airlines Inc.,2071,11,879,0,2660,5621
SMF,SEA,Southwest Airlines Co.,1254,4,710,0,5743,7711
SMF,SFO,Skywest Airlines Inc.,1403,404,7477,0,8127,17411
SMF,SLC,Delta Air Lines Inc.,231,23,66,0,603,923
SMF,SLC,Skywest Airlines Inc.,564,50,154,0,2044,2812
SMF,SNA,Southwest Airlines Co.,1553,257,307,7,4150,6274
SMX,LAX,Skywest Airlines Inc.,2441,50,870,54,2690,6105
SNA,ATL,Delta Air Lines Inc.,534,32,377,0,1234,2177
SNA,AUS,American Airlines Inc.,313,170,94,0,1215,1792
SNA,CVG,Delta Air Lines Inc.,238,0,32,0,501,771
SNA,DEN,Frontier Airlines Inc.,650,36,1211,0,1531,3428
SNA,DEN,United Air Lines Inc.,1478,0,551,0,7122,9151
SNA,DFW,American Airlines Inc.,2690,201,1712,43,10761,15407
SNA,LAS,Southwest Airlines Co.,1008,191,1808,59,4127,7193
SNA,LAS,US Airways Inc.,1385,0,872,11,3804,6072
SNA,LAX,Skywest Airlines Inc.,108,0,231,0,250,589
SNA,OAK,Alaska Airlines Inc.,519,156,290,0,2132,3097
SNA,OAK,Southwest Airlines Co.,1713,84,747,66,8181,10791
SNA,ORD,American Airlines Inc.,3307,0,9798,0,5684,18789
SNA,ORD,United Air Lines Inc.,1578,10,3777,0,3678,9043
SNA,PDX,Alaska Airlines Inc.,1678,52,469,11,2011,4221
SNA,PHX,Southwest Airlines Co.,1032,198,1460,27,5792,8509
SNA,PHX,US Airways Inc.,2132,0,721,134,2089,5076
SNA,SEA,Alaska Airlines Inc.,1954,0,848,26,4587,7415
SNA,SFO,American Eagle Airlines Inc.,573,0,4488,0,2241,7302
SNA,SFO,Skywest Airlines Inc.,1172,134,8674,8,1264,11252
SNA,SFO,United Air Lines Inc.,999,0,3453,0,5018,9470
SNA,SJC,American Airlines Inc.,165,9,168,0,877,1219
SNA,SJC,American Eagle Airlines Inc.,778,188,424,14,4729,6133
SNA,SJC,Southwest Airlines Co.,1384,1,647,2,7479,9513
SNA,SLC,Delta Air Lines Inc.,1991,19,728,0,2038,4776
SNA,SLC,Skywest Airlines Inc.,187,454,0,0,1483,2124
SNA,SMF,Southwest Airlines Co.,1501,149,414,1,5430,7495
SNA,STL,American Airlines Inc.,44,62,78,0,701,885
SPI,ORD,Skywest Airlines Inc.,352,212,4582,0,964,6110
SPS,DFW,American Eagle Airlines Inc.,2048,1699,821,0,5499,10067
SRQ,ATL,Atlantic Southeast Airlines,1376,1116,2240,0,2121,6853
SRQ,ATL,Delta Air Lines Inc.,3421,249,1098,0,2332,7100
SRQ,BOS,Delta Air Lines Inc.,95,0,12,0,179,286
SRQ,DCA,US Airways Inc.,29,0,8,0,32,69
SRQ,JFK,JetBlue Airways,122,0,4087,0,1563,5772
SRQ,LGA,Atlantic Southeast Airlines,47,142,1332,0,235,1756
STL,ABQ,Southwest Airlines Co.,352,43,302,0,1939,2636
STL,ATL,Atlantic Southeast Airlines,3807,1461,1910,0,2892,10070
STL,ATL,Delta Air Lines Inc.,2165,233,1277,0,959,4634
STL,ATL,Skywest Airlines Inc.,0,25,307,0,174,506
STL,AUS,American Airlines Inc.,52,227,144,0,234,657
STL,BHM,Southwest Airlines Co.,946,47,294,0,2274,3561
STL,BNA,American Eagle Airlines Inc.,144,28,104,0,1102,1378
STL,BOS,American Airlines Inc.,560,194,2079,0,1985,4818
STL,BWI,Southwest Airlines Co.,1576,882,1064,25,5428,8975
STL,CLE,Southwest Airlines Co.,1864,586,336,3,2395,5184
STL,CLT,US Airways Inc.,251,9,307,0,1017,1584
STL,CMH,Southwest Airlines Co.,508,201,440,0,1643,2792
STL,DAL,Southwest Airlines Co.,2569,1547,1721,25,10874,16736
STL,DCA,American Airlines Inc.,947,52,926,0,3165,5090
STL,DEN,Frontier Airlines Inc.,446,385,1832,7,1899,4569
STL,DEN,Southwest Airlines Co.,285,53,137,0,603,1078
STL,DEN,United Air Lines Inc.,408,293,750,0,3916,5367
STL,DFW,American Airlines Inc.,3236,1585,3771,0,5493,14085
STL,DTW,Southwest Airlines Co.,976,581,451,0,4399,6407
STL,FLL,American Airlines Inc.,127,0,52,0,0,179
STL,FLL,Southwest Airlines Co.,467,216,311,0,726,1720
STL,HOU,Southwest Airlines Co.,1094,270,1177,4,6588,9133
STL,JFK,American Eagle Airlines Inc.,81,0,629,0,1311,2021
STL,LAS,American Airlines Inc.,95,40,60,0,0,195
STL,LAS,Southwest Airlines Co.,1333,373,1158,4,3507,6375
STL,LAX,American Airlines Inc.,1990,595,1367,0,2807,6759
STL,LAX,Southwest Airlines Co.,476,332,752,0,1157,2717
STL,LGA,American Airlines Inc.,1261,588,9733,0,3467,15049
STL,LIT,Southwest Airlines Co.,476,520,267,9,3940,5212
STL,MCI,Southwest Airlines Co.,1220,729,906,4,8629,11488
STL,MCO,American Airlines Inc.,1319,315,349,0,1000,2983
STL,MCO,Southwest Airlines Co.,1430,210,760,14,2717,5131
STL,MDW,Southwest Airlines Co.,3681,2515,4484,25,11674,22379
STL,MIA,American Airlines Inc.,587,75,431,0,791,1884
STL,MKE,Skywest Airlines Inc.,632,1178,573,0,471,2854
STL,OKC,Southwest Airlines Co.,268,69,357,6,4212,4912
STL,OMA,Southwest Airlines Co.,1122,379,610,17,4830,6958
STL,ORD,American Airlines Inc.,1848,548,19906,0,15083,37385
STL,PHL,Southwest Airlines Co.,275,844,1595,0,1201,3915
STL,PHX,Southwest Airlines Co.,2243,821,1128,26,4372,8590
STL,PHX,US Airways Inc.,1181,780,215,8,1058,3242
STL,RDU,American Airlines Inc.,577,128,173,0,314,1192
STL,RSW,American Airlines Inc.,325,45,291,0,127,788
STL,SAN,American Airlines Inc.,438,0,159,0,243,840
STL,SAT,American Airlines Inc.,550,61,125,0,719,1455
STL,SDF,Southwest Airlines Co.,1906,104,693,0,3479,6182
STL,SEA,American Airlines Inc.,934,156,160,0,444,1694
STL,SFO,American Airlines Inc.,1191,23,2555,0,532,4301
STL,SGF,American Eagle Airlines Inc.,272,0,261,0,4363,4896
STL,SLC,Skywest Airlines Inc.,539,346,811,9,2122,3827
STL,SLC,Southwest Airlines Co.,503,120,414,11,2363,3411
STL,SNA,American Airlines Inc.,654,69,137,0,55,915
STL,TPA,American Airlines Inc.,1015,81,406,0,835,2337
STL,TPA,Southwest Airlines Co.,595,38,323,11,1220,2187
STL,TUL,Southwest Airlines Co.,841,292,569,18,5603,7323
STT,ATL,Delta Air Lines Inc.,549,0,273,0,491,1313
STT,BOS,American Airlines Inc.,52,0,108,0,550,710
STT,CLT,US Airways Inc.,222,0,211,6,760,1199
STT,JFK,American Airlines Inc.,1772,27,592,0,2121,4512
STT,JFK,Delta Air Lines Inc.,41,31,429,0,639,1140
STT,LGA,US Airways Inc.,43,0,70,0,93,206
STT,MIA,American Airlines Inc.,2365,34,333,0,760,3492
STT,PHL,US Airways Inc.,627,0,358,1,2502,3488
STT,SJU,American Airlines Inc.,133,36,61,0,1642,1872
STT,SJU,United Air Lines Inc.,362,25,79,0,1237,1703
STX,ATL,Delta Air Lines Inc.,76,0,33,0,47,156
STX,CLT,US Airways Inc.,92,0,56,12,94,254
STX,MIA,American Airlines Inc.,243,51,178,0,1800,2272
SUN,SLC,Skywest Airlines Inc.,2067,1854,322,32,1125,5400
SWF,ATL,Atlantic Southeast Airlines,6983,1684,3049,0,454,12170
SWF,FLL,JetBlue Airways,504,0,357,0,791,1652
SWF,MCO,JetBlue Airways,1380,88,229,0,1594,3291
SWF,PBI,JetBlue Airways,169,51,124,0,236,580
SYR,ATL,Atlantic Southeast Airlines,2633,652,2124,0,1450,6859
SYR,CLT,US Airways Inc.,850,12,369,0,724,1955
SYR,DCA,US Airways Inc.,120,0,35,0,0,155
SYR,DFW,American Eagle Airlines Inc.,143,24,129,0,690,986
SYR,FLL,JetBlue Airways,199,158,260,0,534,1151
SYR,JFK,JetBlue Airways,2973,96,3101,0,3903,10073
SYR,MCO,JetBlue Airways,627,0,204,0,620,1451
SYR,ORD,American Eagle Airlines Inc.,3676,428,5237,0,5922,15263
SYR,ORD,Skywest Airlines Inc.,385,0,3431,0,981,4797
SYR,PHL,US Airways Inc.,176,6,333,0,0,515
TLH,ATL,Atlantic Southeast Airlines,4613,3163,3294,0,1192,12262
TLH,ATL,Delta Air Lines Inc.,792,12,514,0,1021,2339
TLH,FLL,Atlantic Southeast Airlines,263,182,67,0,7,519
TLH,MCO,Atlantic Southeast Airlines,376,214,20,0,17,627
TLH,MIA,American Eagle Airlines Inc.,281,51,113,0,1643,2088
TLH,MIA,Atlantic Southeast Airlines,505,458,29,0,9,1001
TLH,TPA,Atlantic Southeast Airlines,536,210,8,0,232,986
TOL,ATL,Atlantic Southeast Airlines,1187,91,282,0,5,1565
TOL,ORD,American Eagle Airlines Inc.,407,166,3703,0,4365,8641
TPA,ABQ,Southwest Airlines Co.,619,237,199,0,1575,2630
TPA,ALB,Southwest Airlines Co.,888,180,447,0,659,2174
TPA,ATL,Delta Air Lines Inc.,4523,483,4343,0,5268,14617
TPA,AUS,Southwest Airlines Co.,198,0,149,0,535,882
TPA,BDL,Delta Air Lines Inc.,761,9,227,0,2271,3268
TPA,BDL,Southwest Airlines Co.,971,277,583,0,2235,4066
TPA,BHM,Southwest Airlines Co.,1156,0,384,16,2438,3994
TPA,BNA,Southwest Airlines Co.,2745,174,558,0,6067,9544
TPA,BOS,Delta Air Lines Inc.,1030,14,629,0,2390,4063
TPA,BOS,JetBlue Airways,955,0,1997,0,2033,4985
TPA,BUF,Southwest Airlines Co.,1236,366,201,0,1720,3523
TPA,BWI,Southwest Airlines Co.,2504,848,1496,0,8388,13236
TPA,CLT,US Airways Inc.,1512,656,1384,30,3781,7363
TPA,CMH,Southwest Airlines Co.,1418,166,306,14,4218,6122
TPA,CVG,Delta Air Lines Inc.,732,30,277,0,2231,3270
TPA,DCA,US Airways Inc.,1463,293,890,0,3054,5700
TPA,DEN,Frontier Airlines Inc.,680,88,711,0,383,1862
TPA,DEN,Southwest Airlines Co.,364,30,86,0,430,910
TPA,DEN,United Air Lines Inc.,1266,142,730,0,4477,6615
TPA,DFW,American Airlines Inc.,3405,579,2016,0,8358,14358
TPA,EWR,JetBlue Airways,601,1,5857,0,1201,7660
TPA,FLL,Southwest Airlines Co.,2451,820,1734,0,10465,15470
TPA,HOU,Southwest Airlines Co.,1477,430,686,0,4174,6767
TPA,IAD,Southwest Airlines Co.,841,173,945,0,2924,4883
TPA,IAD,United Air Lines Inc.,1471,371,530,0,3962,6334
TPA,IND,Southwest Airlines Co.,582,222,257,0,1961,3022
TPA,ISP,Southwest Airlines Co.,1239,78,977,0,2577,4871
TPA,JAX,Southwest Airlines Co.,638,575,301,0,2904,4418
TPA,JFK,American Airlines Inc.,461,22,348,0,0,831
TPA,JFK,Delta Air Lines Inc.,1435,218,2025,0,2287,5965
TPA,JFK,JetBlue Airways,1205,26,5236,0,5515,11982
TPA,LAS,Southwest Airlines Co.,1075,222,656,0,1162,3115
TPA,LAS,US Airways Inc.,337,149,384,0,859,1729
TPA,LAX,Delta Air Lines Inc.,366,0,220,0,1050,1636
TPA,LGA,American Airlines Inc.,1708,18,1852,0,1564,5142
TPA,LGA,Delta Air Lines Inc.,787,104,2024,0,709,3624
TPA,MCI,Southwest Airlines Co.,1042,13,169,0,2652,3876
TPA,MDW,Southwest Airlines Co.,1490,783,1093,21,6184,9571
TPA,MHT,Southwest Airlines Co.,1146,150,464,0,2706,4466
TPA,MIA,American Airlines Inc.,1626,507,1388,0,7673,11194
TPA,MSY,Southwest Airlines Co.,1344,0,309,0,4119,5772
TPA,ORD,American Airlines Inc.,2266,73,5451,0,3067,10857
TPA,ORD,United Air Lines Inc.,3584,127,3931,0,4684,12326
TPA,ORF,Southwest Airlines Co.,214,127,36,0,663,1040
TPA,PBI,Southwest Airlines Co.,2313,304,423,0,4622,7662
TPA,PHL,Southwest Airlines Co.,2839,1722,4464,1,5212,14238
TPA,PHL,US Airways Inc.,1681,517,3411,26,3446,9081
TPA,PHX,Southwest Airlines Co.,643,96,336,0,1208,2283
TPA,PHX,US Airways Inc.,408,310,150,0,388,1256
TPA,PIT,Southwest Airlines Co.,339,235,207,0,765,1546
TPA,PIT,US Airways Inc.,286,257,177,0,753,1473
TPA,PNS,Atlantic Southeast Airlines,33,263,29,0,0,325
TPA,PVD,Southwest Airlines Co.,1485,100,354,0,3406,5345
TPA,RDU,Southwest Airlines Co.,813,262,282,0,1664,3021
TPA,SAT,Southwest Airlines Co.,387,318,212,0,2067,2984
TPA,SDF,Southwest Airlines Co.,768,19,125,0,659,1571
TPA,SJU,American Airlines Inc.,471,0,34,0,0,505
TPA,SLC,Delta Air Lines Inc.,184,6,270,0,724,1184
TPA,STL,American Airlines Inc.,325,96,265,0,1214,1900
TPA,STL,Southwest Airlines Co.,966,338,212,7,1740,3263
TPA,TLH,Atlantic Southeast Airlines,105,153,108,0,130,496
TRI,ATL,Atlantic Southeast Airlines,4860,715,2249,7,340,8171
TRI,CVG,Atlantic Southeast Airlines,642,0,59,0,28,729
TUL,ASE,Skywest Airlines Inc.,0,0,61,0,0,61
TUL,ATL,Atlantic Southeast Airlines,7092,1886,2443,0,631,12052
TUL,ATL,Skywest Airlines Inc.,278,0,305,0,326,909
TUL,CVG,Atlantic Southeast Airlines,781,317,108,0,74,1280
TUL,DAL,Southwest Airlines Co.,1638,1096,1182,48,5461,9425
TUL,DEN,Frontier Airlines Inc.,0,0,9,0,24,33
TUL,DEN,Skywest Airlines Inc.,769,81,365,0,1515,2730
TUL,DEN,United Air Lines Inc.,1274,207,518,0,2205,4204
TUL,DFW,American Airlines Inc.,2182,1511,1830,0,2680,8203
TUL,DFW,American Eagle Airlines Inc.,636,410,1102,0,5995,8143
TUL,HOU,Southwest Airlines Co.,715,252,1044,45,6524,8580
TUL,LAS,Southwest Airlines Co.,414,70,279,0,978,1741
TUL,LAX,Skywest Airlines Inc.,154,0,0,0,0,154
TUL,MCI,Southwest Airlines Co.,418,110,281,29,3853,4691
TUL,ORD,American Airlines Inc.,842,329,6837,0,5019,13027
TUL,ORD,American Eagle Airlines Inc.,158,36,1155,0,1576,2925
TUL,ORD,Skywest Airlines Inc.,480,0,5836,0,941,7257
TUL,PHX,Southwest Airlines Co.,783,101,394,62,1758,3098
TUL,SLC,Skywest Airlines Inc.,1120,266,105,0,549,2040
TUL,STL,Southwest Airlines Co.,769,344,206,25,1318,2662
TUS,ABQ,Southwest Airlines Co.,329,0,60,3,1747,2139
TUS,ATL,Delta Air Lines Inc.,706,267,487,0,1139,2599
TUS,CLT,US Airways Inc.,156,0,5,0,0,161
TUS,DEN,Frontier Airlines Inc.,105,0,579,0,604,1288
TUS,DEN,Skywest Airlines Inc.,1434,0,178,0,980,2592
TUS,DEN,United Air Lines Inc.,152,0,93,0,2748,2993
TUS,DFW,American Airlines Inc.,4332,109,2935,0,5075,12451
TUS,IAD,United Air Lines Inc.,72,0,14,0,10,96
TUS,JFK,JetBlue Airways,373,0,136,0,678,1187
TUS,LAS,Southwest Airlines Co.,1183,108,1640,5,6744,9680
TUS,LAX,Skywest Airlines Inc.,1856,0,609,20,1788,4273
TUS,LAX,Southwest Airlines Co.,2374,27,1021,38,5732,9192
TUS,MDW,Southwest Airlines Co.,255,0,471,0,429,1155
TUS,OAK,Southwest Airlines Co.,163,0,14,0,17,194
TUS,ORD,American Airlines Inc.,1431,13,4383,0,4754,10581
TUS,PHX,US Airways Inc.,252,0,64,0,422,738
TUS,SAN,Southwest Airlines Co.,1370,96,687,4,5642,7799
TUS,SEA,Alaska Airlines Inc.,642,0,109,5,325,1081
TUS,SFO,Skywest Airlines Inc.,546,0,37,0,0,583
TUS,SLC,Skywest Airlines Inc.,2040,409,141,0,2720,5310
TVC,DEN,Skywest Airlines Inc.,35,0,16,0,0,51
TVC,LGA,American Eagle Airlines Inc.,0,0,0,0,42,42
TVC,MSN,Skywest Airlines Inc.,54,0,0,0,0,54
TVC,ORD,American Eagle Airlines Inc.,2812,98,3477,0,3257,9644
TVC,ORD,Skywest Airlines Inc.,717,667,8466,0,1241,11091
TWF,SLC,Skywest Airlines Inc.,920,3197,0,0,3426,7543
TXK,DFW,American Eagle Airlines Inc.,1475,2019,727,0,3036,7257
TYR,DFW,American Eagle Airlines Inc.,1795,1223,1495,0,3974,8487
TYS,ATL,Atlantic Southeast Airlines,4047,2907,3990,0,2344,13288
TYS,ATL,Delta Air Lines Inc.,909,125,475,0,0,1509
TYS,CVG,Atlantic Southeast Airlines,501,0,9,0,0,510
TYS,DEN,Skywest Airlines Inc.,454,74,283,15,621,1447
TYS,DFW,American Eagle Airlines Inc.,1327,226,1450,0,5708,8711
TYS,MCO,Atlantic Southeast Airlines,323,0,47,0,15,385
TYS,ORD,American Eagle Airlines Inc.,687,364,3051,0,4402,8504
TYS,ORD,Skywest Airlines Inc.,474,189,4029,0,849,5541
VLD,ATL,Atlantic Southeast Airlines,4123,1376,1815,0,191,7505
VPS,ATL,Atlantic Southeast Airlines,8473,2246,4082,14,1158,15973
VPS,ATL,Delta Air Lines Inc.,807,40,590,0,1261,2698
VPS,DFW,American Eagle Airlines Inc.,2825,1363,1821,0,7482,13491
VPS,ORD,American Eagle Airlines Inc.,1476,211,2629,0,2411,6727
WRG,KTN,Alaska Airlines Inc.,118,28,136,0,1090,1372
WRG,PSG,Alaska Airlines Inc.,106,246,90,0,1083,1525
WYS,SLC,Skywest Airlines Inc.,0,0,3,0,18,21
XNA,ATL,Atlantic Southeast Airlines,3609,531,1457,0,384,5981
XNA,ATL,Skywest Airlines Inc.,207,57,219,0,427,910
XNA,CVG,Atlantic Southeast Airlines,18,0,12,0,0,30
XNA,DCA,American Eagle Airlines Inc.,838,303,187,0,0,1328
XNA,DEN,Skywest Airlines Inc.,1103,91,320,13,949,2476
XNA,DFW,American Airlines Inc.,993,139,1147,0,2734,5013
XNA,DFW,American Eagle Airlines Inc.,4187,2167,2978,22,4753,14107
XNA,LAX,American Eagle Airlines Inc.,1343,31,660,0,1342,3376
XNA,LEX,Skywest Airlines Inc.,0,59,0,0,0,59
XNA,LGA,American Eagle Airlines Inc.,2831,764,2777,0,2277,8649
XNA,MEM,Skywest Airlines Inc.,0,0,0,0,23,23
XNA,MIA,American Eagle Airlines Inc.,399,110,203,0,1627,2339
XNA,ORD,American Eagle Airlines Inc.,5654,1087,9094,0,7652,23487
XNA,ORD,Skywest Airlines Inc.,1025,415,9414,0,1140,11994
XNA,RDU,American Eagle Airlines Inc.,1642,226,165,0,0,2033
XNA,SGF,Skywest Airlines Inc.,0,0,0,0,70,70
YAK,CDV,Alaska Airlines Inc.,58,30,114,0,2338,2540
YAK,JNU,Alaska Airlines Inc.,52,18,32,0,1532,1634
YKM,SLC,Skywest Airlines Inc.,422,159,14,0,432,1027
YUM,IPL,Skywest Airlines Inc.,789,21,5,0,453,1268
YUM,LAX,Skywest Airlines Inc.,1129,91,166,167,827,2380
YUM,SLC,Skywest Airlines Inc.,1190,0,167,203,435,1995
